ATAAATGCTATCTTATACA -> TAAATGCTATCTTATACAG
AATATGAAATCGAAGCGGT -> ATATGAAATCGAAGCGGTT
ACTCAATGGATGACAGTGA -> CTCAATGGATGACAGTGAT
TCCGCTCCGTTTAGCCCCG -> CCGCTCCGTTTAGCCCCGG
ATCCTTTACGAGCGGCACC -> TCCTTTACGAGCGGCACCT
CTAGCTCTGTTGTTGTTAA -> TAGCTCTGTTGTTGTTAAA
TCCCGGGCCCCTCGATTCC -> CCCGGGCCCCTCGATTCCA
GCTATCTTATACAGTAGTC -> CTATCTTATACAGTAGTCC
AGATTTCTCCCCTCCGAAA -> GATTTCTCCCCTCCGAAAA
ATTAATCTGCTCTGATCTT -> TTAATCTGCTCTGATCTTA
ATATACAAAGAGATCCGAT -> TATACAAAGAGATCCGATG
AGAATGACGTGACGATCAG -> GAATGACGTGACGATCAGG
GTTGTTGTTAAAGACTGAG -> TTGTTGTTAAAGACTGAGG
GCACCTACCCTCAGTACCC -> CACCTACCCTCAGTACCCT
AGGCCACGTAAAGCAAGCC -> GGCCACGTAAAGCAAGCCG
GATATCAAAGTTCAGATTG -> ATATCAAAGTTCAGATTGG
CCCTATAAAAATCCATTCC -> CCTATAAAAATCCATTCCC
GACCCGGAAAATATAGAGT -> ACCCGGAAAATATAGAGTC
ACTGCGGGTCGGGCGTTCA -> CTGCGGGTCGGGCGTTCAC
AGGCTTAGGTAACCCGGGG -> GGCTTAGGTAACCCGGGGC
TACGAGCGGCACCTACCCT -> ACGAGCGGCACCTACCCTC
GCATTAATCCCCACACGGC -> CATTAATCCCCACACGGCA
TCGTAACGGGGCCTAATAC -> CGTAACGGGGCCTAATACC
GCGGGTCGGGCGTTCACTA -> CGGGTCGGGCGTTCACTAG
GCTTACCAAAGAAAGATAT -> CTTACCAAAGAAAGATATC
CTTCCATTATCCATCAGAC -> TTCCATTATCCATCAGACA
CTGTTGTTGTTAAAGACTG -> TGTTGTTGTTAAAGACTGA
TAAAAATCCATTCCCTGGG -> AAAAATCCATTCCCTGGGC
TGGGGCCAGAGACAGGTGT -> GGGGCCAGAGACAGGTGTC
CTGGCTTCCAGGCTTAGGT -> TGGCTTCCAGGCTTAGGTA
AGCAAGCCGCTATGGTTTC -> GCAAGCCGCTATGGTTTCT
TGAAATCGAAGCGGTTTGA -> GAAATCGAAGCGGTTTGAA
GTTTGAAACGTCCGTCTTA -> TTTGAAACGTCCGTCTTAT
TCGACACAGCTCCCTTGAC -> CGACACAGCTCCCTTGACG
CCACGTAAAGCAAGCCGCT -> CACGTAAAGCAAGCCGCTA
TCAAGTGGCCTTCTACTGG -> CAAGTGGCCTTCTACTGGG
TTAATGTTGCTCTGTAGTA -> TAATGTTGCTCTGTAGTAG
CACTTCTTCGTAACTCGAC -> ACTTCTTCGTAACTCGACA
TAAATTGTTTCGGAAGTAA -> AAATTGTTTCGGAAGTAAC
CCTTTGTGGCTCGTAACGG -> CTTTGTGGCTCGTAACGGG
CAGCTCAGACGCGGGTAAT -> AGCTCAGACGCGGGTAATG
AAAAGGCGCGACCTATGTT -> AAAGGCGCGACCTATGTTT
GATTTCTCCCCTCCGAAAA -> ATTTCTCCCCTCCGAAAAA
CTGCTCTGATCTTAGAGGA -> TGCTCTGATCTTAGAGGAT
GCGCGAGTGAAGGCCACGT -> CGCGAGTGAAGGCCACGTA
GACCTAATGTGCCGCTTTC -> ACCTAATGTGCCGCTTTCT
CTGGCTCCAAGTCAAATCT -> TGGCTCCAAGTCAAATCTC
CCATTGATTGGTAGAAACA -> CATTGATTGGTAGAAACAA
CCTATGGGTAAAGCGACAA -> CTATGGGTAAAGCGACAAC
CCGACGTTGACCTGTGGCA -> CGACGTTGACCTGTGGCAC
GCGAAAGCGCACTTCTTCG -> CGAAAGCGCACTTCTTCGT
CAAATCTCCTCAACATAAC -> AAATCTCCTCAACATAACC
ATGACAGTGATACGCAAAC -> TGACAGTGATACGCAAACG
GGGGCCTAATACCCCCTAC -> GGGCCTAATACCCCCTACT
GATGACCCGTGCGAAAGCG -> ATGACCCGTGCGAAAGCGC
GATGAACCTATATGCGAAA -> ATGAACCTATATGCGAAAT
CCGTTTCTGCCGACGTTGA -> CGTTTCTGCCGACGTTGAC
AGCAAAATTTAAGTTTGGA -> GCAAAATTTAAGTTTGGAT
TTGACTTTGCTAGCTCTGT -> TGACTTTGCTAGCTCTGTT
ACATAAGGGTATGGGGAGG -> CATAAGGGTATGGGGAGGA
ATTAATGACTACGCATGGG -> TTAATGACTACGCATGGGA
CGTTTAGCCCCGGTCACGC -> GTTTAGCCCCGGTCACGCG
ACTCCCCTATAAAAATCCA -> CTCCCCTATAAAAATCCAT
TCGAAGCGGTTTGAAACGT -> CGAAGCGGTTTGAAACGTC
GGCCAGAGACAGGTGTCGC -> GCCAGAGACAGGTGTCGCG
AGTCAGCTCAGACGCGGGT -> GTCAGCTCAGACGCGGGTA
AGTCGATCCGATTGATGCA -> GTCGATCCGATTGATGCAC
GACCTGTGGCACTTTGCAG -> ACCTGTGGCACTTTGCAGC
TTAGGTAACAGAGTTTATG -> TAGGTAACAGAGTTTATGA
ACTCGACACAGCTCCCTTG -> CTCGACACAGCTCCCTTGA
AAGATCTTTTGGTTCCGCT -> AGATCTTTTGGTTCCGCTC
CGCGGCGAGGCACATTTCC -> GCGGCGAGGCACATTTCCC
CTGCGGGTCGGGCGTTCAC -> TGCGGGTCGGGCGTTCACT
GATCTTTTGGTTCCGCTCC -> ATCTTTTGGTTCCGCTCCG
TATCGCCTTTGGACGGTTA -> ATCGCCTTTGGACGGTTAC
TTGACCTGTGGCACTTTGC -> TGACCTGTGGCACTTTGCA
CAGCTCCCTTGACGTTCAT -> AGCTCCCTTGACGTTCATG
AATGGATGACAGTGATACG -> ATGGATGACAGTGATACGC
TCTTTGTTTCACGCGAAGA -> CTTTGTTTCACGCGAAGAT
CCTCGATTCCAGGTCATGG -> CTCGATTCCAGGTCATGGA
AGTAAATGATTGGTCCCAT -> GTAAATGATTGGTCCCATA
GTTAAGATCCTTTACATAA -> TTAAGATCCTTTACATAAG
TCGAACCAGCTCGATCTCC -> CGAACCAGCTCGATCTCCT
CGTCATCCTTCGGGTCGAA -> GTCATCCTTCGGGTCGAAC
ATATGGCAGACAGTGCATC -> TATGGCAGACAGTGCATCC
AATGAGACAGACCGGGAAT -> ATGAGACAGACCGGGAATG
CCGTCAACGGGACCGCCCA -> CGTCAACGGGACCGCCCAT
GGTAACCCGGGGCCCGCTT -> GTAACCCGGGGCCCGCTTC
TGACAATGTTCCCCAGCAA -> GACAATGTTCCCCAGCAAA
CCAAGTCAAATCTCCTCAA -> CAAGTCAAATCTCCTCAAC
TCAGAATATGAAATCGAAG -> CAGAATATGAAATCGAAGC
AGACTTGTTGATCGGACCT -> GACTTGTTGATCGGACCTA
TAGGCGCGAGTGAAGGCCA -> AGGCGCGAGTGAAGGCCAC
TGCCGATGAACCTATATGC -> GCCGATGAACCTATATGCG
AGCGGCTTCAGCGCGTCGA -> GCGGCTTCAGCGCGTCGAG
GATTCCAGGTCATGGACAG -> ATTCCAGGTCATGGACAGT
TGTACCGGTCGCATTAATG -> GTACCGGTCGCATTAATGA,GTACCGGTCGCATTAATGT
CCGAAAATCCCTTTGTGGC -> CGAAAATCCCTTTGTGGCT
CCAGGTCATGGACAGTGGC -> CAGGTCATGGACAGTGGCA
CTAAATTGTTTCGGAAGTA -> TAAATTGTTTCGGAAGTAA
AGACACTAATGATGGAACT -> GACACTAATGATGGAACTG
TTAGAGGATCGGTTACGTT -> TAGAGGATCGGTTACGTTG
TACGCAAACGCCTCTAAAC -> ACGCAAACGCCTCTAAACG
GAGACAGGTGTCGCGGCGA -> AGACAGGTGTCGCGGCGAG
CCATGTACGATCTACTTCC -> CATGTACGATCTACTTCCA
TGATTGGTAGAAACAACTG -> GATTGGTAGAAACAACTGC
CATCCTTCGGGTCGAACCA -> ATCCTTCGGGTCGAACCAG
ACACCCTTGGACGTACTGT -> CACCCTTGGACGTACTGTA
TCCCTTGACGTTCATGCTT -> CCCTTGACGTTCATGCTTG
TTCCATTATCCATCAGACA -> TCCATTATCCATCAGACAC
GACCCGTGCGAAAGCGCAC -> ACCCGTGCGAAAGCGCACT
CTATGGTTTCTCAAAGGTT -> TATGGTTTCTCAAAGGTTA
TTACGGCGTCATCCTTCGG -> TACGGCGTCATCCTTCGGG
CCCTTGTCGGCTGTACCGG -> CCTTGTCGGCTGTACCGGT
ATAGGCACTAGTCTACACA -> TAGGCACTAGTCTACACAG
ACAAAGTCTGGCTCCAAGT -> CAAAGTCTGGCTCCAAGTC
TGACAGTGATACGCAAACG -> GACAGTGATACGCAAACGC
GACAGGTGTCGCGGCGAGG -> ACAGGTGTCGCGGCGAGGC
GCTCCCTTGACGTTCATGC -> CTCCCTTGACGTTCATGCT
ATCTTTGTTTCACGCGAAG -> TCTTTGTTTCACGCGAAGA
ATCCGATGAATAGTTAAGA -> TCCGATGAATAGTTAAGAT
GAAGGAGGCTCCTGGGGCC -> AAGGAGGCTCCTGGGGCCA
GCTTGACCGTTATTGATCC -> CTTGACCGTTATTGATCCA
GCATGTCAGCTCAACTAAA -> CATGTCAGCTCAACTAAAC
GCTCCTTTAGCTAAATTGT -> CTCCTTTAGCTAAATTGTT
TCCTCAACATAACCGGCCG -> CCTCAACATAACCGGCCGT
ACTGTACCGGTCGCATTAA -> CTGTACCGGTCGCATTAAT,CTGTACCGGTCGCATTAAT,CTGTACCGGTCGCATTAAT
AAGGAGGCTCCTGGGGCCA -> AGGAGGCTCCTGGGGCCAG
TGCCGACGTTGACCTGTGG -> GCCGACGTTGACCTGTGGC
CGTTGACCTGTGGCACTTT -> GTTGACCTGTGGCACTTTG
TATTGCCGTTTCTGCCGAC -> ATTGCCGTTTCTGCCGACG
TTTTCGACAATAAGTCGAT -> TTTCGACAATAAGTCGATC
TGGGACTAGTGAAGTTGAC -> GGGACTAGTGAAGTTGACT
ATACCCGGCCGGGACACAA -> TACCCGGCCGGGACACAAA
ATTATCCATCAGACACCCT -> TTATCCATCAGACACCCTT
GAGGATCGGTTACGTTGCA -> AGGATCGGTTACGTTGCAC
CTGACAATGTTCCCCAGCA -> TGACAATGTTCCCCAGCAA
CTCTGGACGATAACAGCCC -> TCTGGACGATAACAGCCCA
CCTTGTCGGCTGTACCGGT -> CTTGTCGGCTGTACCGGTC
GCGCGACCTATGTTTAACG -> CGCGACCTATGTTTAACGG
GTCTTCCATTATCCATCAG -> TCTTCCATTATCCATCAGA
ATAGGGCGTCCATAATGTT -> TAGGGCGTCCATAATGTTC
TCCGTTTAGCCCCGGTCAC -> CCGTTTAGCCCCGGTCACG
TATGAAATCGAAGCGGTTT -> ATGAAATCGAAGCGGTTTG
GCCGCTGTAATGGAATTCA -> CCGCTGTAATGGAATTCAA
GGGTCGGGCGTTCACTAGT -> GGTCGGGCGTTCACTAGTC
GCACGGACAAAGTCTGGCT -> CACGGACAAAGTCTGGCTC
CCGTCCTATCCGGCAACTC -> CGTCCTATCCGGCAACTCC
CGCCTCTAAACGGATAGGG -> GCCTCTAAACGGATAGGGC
ACACAGGTCTTCCATTATC -> CACAGGTCTTCCATTATCC
TTATCGCCTTTGGACGGTT -> TATCGCCTTTGGACGGTTA
ACCCATTATCCATCAGACA -> CCCATTATCCATCAGACAC
ACCCTTGGACGTACTGTAC -> CCCTTGGACGTACTGTACC
GAGTATGTGCGAGGGCCAA -> AGTATGTGCGAGGGCCAAC
TTGGATCAACGTTTTAGGG -> TGGATCAACGTTTTAGGGA
TAAATGATTGGTCCCATAT -> AAATGATTGGTCCCATATT
CGATCACGGACTGGCTTCC -> GATCACGGACTGGCTTCCA
AAAATACGTTTTCGACAAT -> AAATACGTTTTCGACAATA
GCCGGGACACAAACCTGCG -> CCGGGACACAAACCTGCGT
CGAAAGCGCACTTCTTCGT -> GAAAGCGCACTTCTTCGTA
CGGGGCCTAATACCCCCTA -> GGGGCCTAATACCCCCTAC
ATCTTTTGGTTCCGCTCCG -> TCTTTTGGTTCCGCTCCGT
TCTTCGTTCATCGGAGAGG -> CTTCGTTCATCGGAGAGGC
GGGCGTCCATAATGTTCGC -> GGCGTCCATAATGTTCGCG
ATACATGTTAATACCCGGC -> TACATGTTAATACCCGGCC
GCAGCGATCCTTTACGAGC -> CAGCGATCCTTTACGAGCG
CCTATAAAAATCCATTCCC -> CTATAAAAATCCATTCCCT
CGGCGTCATCCTTCGGGTC -> GGCGTCATCCTTCGGGTCG
GGTTTCTCAAAGGTTAGAT -> GTTTCTCAAAGGTTAGATG
ATTCCAGGTCATGGACAGT -> TTCCAGGTCATGGACAGTG
GTAGACCTAATGTGCCGCT -> TAGACCTAATGTGCCGCTT
GTCCCATATTGCCGTTTCT -> TCCCATATTGCCGTTTCTG
TCGCATTAATCTGCTCTGA -> CGCATTAATCTGCTCTGAT
AGTGGCCTTCTACTGGGTG -> GTGGCCTTCTACTGGGTGT
GCACACCTGCTTCTTATCG -> CACACCTGCTTCTTATCGC
TAGTGAAGTTGACTTTGCT -> AGTGAAGTTGACTTTGCTA
TAGACCTAATGTGCCGCTT -> AGACCTAATGTGCCGCTTT
GTTCCCCAGCAAAATTTAA -> TTCCCCAGCAAAATTTAAG
TGTACGATCTACTTCCAGT -> GTACGATCTACTTCCAGTC
AAACCATTATCCATCAGAC -> AACCATTATCCATCAGACA
GGTCGCATTAATCCCCACA -> GTCGCATTAATCCCCACAC
ACAAAGAGATCCGATGAAT -> CAAAGAGATCCGATGAATA
ATCCATAGGGCGTCCATAA -> TCCATAGGGCGTCCATAAT
CTGTGGCACTTTGCAGCGA -> TGTGGCACTTTGCAGCGAT
GTTCCGCTCCGTTTAGCCC -> TTCCGCTCCGTTTAGCCCC
CGAGTGAAGGCCACGTAAA -> GAGTGAAGGCCACGTAAAG
ACGCAAACGCCTCTAAACG -> CGCAAACGCCTCTAAACGG
CTTGGACGTACTGTACCGG -> TTGGACGTACTGTACCGGT
TGGCTACCTGACAGAATTA -> GGCTACCTGACAGAATTAG
CCTAACTCCCCTATAAAAA -> CTAACTCCCCTATAAAAAT
GAGGGGTTAGAATGACGTG -> AGGGGTTAGAATGACGTGA
GAACTTGAGGGAGTAGAAA -> AACTTGAGGGAGTAGAAAA
CTCCGATATACAAAGAGAT -> TCCGATATACAAAGAGATC
GATGAATAGTTAAGATCCT -> ATGAATAGTTAAGATCCTT
TTTACGGCGTCATCCTTCG -> TTACGGCGTCATCCTTCGG
CGTCAACGGGACCGCCCAT -> GTCAACGGGACCGCCCATG
GCCCGAAGTGAGGAAGTCT -> CCCGAAGTGAGGAAGTCTA
GGACGATAACAGCCCAGCG -> GACGATAACAGCCCAGCGC
TCAAAGTTCAGATTGGACG -> CAAAGTTCAGATTGGACGA
AGCCCAGCGCGTAATTTAC -> GCCCAGCGCGTAATTTACG
GCTCTGTAGTAGACCTAAT -> CTCTGTAGTAGACCTAATG
GCTATGGTTTCTCAAAGGT -> CTATGGTTTCTCAAAGGTT
CTTTCTTGATGCCATTATC -> TTTCTTGATGCCATTATCC
TGGCAGACAGTGCATCCAA -> GGCAGACAGTGCATCCAAT
CGAAACCCTGAACTTGAGG -> GAAACCCTGAACTTGAGGG
GGAAGTAACTTCGATTTTG -> GAAGTAACTTCGATTTTGA
TTATACAGTAGTCCTTTCC -> TATACAGTAGTCCTTTCCG
GCACTAGTCTACACAGGTC -> CACTAGTCTACACAGGTCT
ACACTAATGATGGAACTGT -> CACTAATGATGGAACTGTA
TTTGCTAGCTCTGTTGTTG -> TTGCTAGCTCTGTTGTTGT
TGCTCTGTAGTAGACCTAA -> GCTCTGTAGTAGACCTAAT
ATGTTCCCCAGCAAAATTT -> TGTTCCCCAGCAAAATTTA
TTCTTCGTAACTCGACACA -> TCTTCGTAACTCGACACAG
GTGACATCTTTGTTTCACG -> TGACATCTTTGTTTCACGC
GTGGTTGAGGGGTTAGAAT -> TGGTTGAGGGGTTAGAATG
CTGCCGATGAACCTATATG -> TGCCGATGAACCTATATGC
TAAGTTTGGATCAACGTTT -> AAGTTTGGATCAACGTTTT
GGAGGAAGCCGCTGTAATG -> GAGGAAGCCGCTGTAATGG
CCATCAGACACTAATGATG -> CATCAGACACTAATGATGG
CCGCTATGGTTTCTCAAAG -> CGCTATGGTTTCTCAAAGG
GCGAGTGAAGGCCACGTAA -> CGAGTGAAGGCCACGTAAA
TTGATCGGACCTATGGGTA -> TGATCGGACCTATGGGTAA
GACGATCAGGGAAGATCTT -> ACGATCAGGGAAGATCTTT
TCAGGGAAGATCTTTTGGT -> CAGGGAAGATCTTTTGGTT
TGATACGCAAACGCCTCTA -> GATACGCAAACGCCTCTAA
AAGCGGTTTGAAACGTCCG -> AGCGGTTTGAAACGTCCGT
TAGAAAAATACGTTTTCGA -> AGAAAAATACGTTTTCGAC
TTCTGGGTGACATCTTTGT -> TCTGGGTGACATCTTTGTT
GAAGTGAGGAAGTCTAGAT -> AAGTGAGGAAGTCTAGATA
CGTAATTTACGGCGTCATC -> GTAATTTACGGCGTCATCC
AGGGCCCGAAGTGAGGAAG -> GGGCCCGAAGTGAGGAAGT
CGGCAACTCCGATATACAA -> GGCAACTCCGATATACAAA
CGGGTCGAACCAGCTCGAT -> GGGTCGAACCAGCTCGATC
GATCAACGTTTTAGGGAGT -> ATCAACGTTTTAGGGAGTC
TATGATAGTGGGTCTAGGG -> ATGATAGTGGGTCTAGGGA
AGTTCAGATTGGACGATCT -> GTTCAGATTGGACGATCTG
AGATCCGATGAATAGTTAA -> GATCCGATGAATAGTTAAG
CGTTTCTGCCGACGTTGAC -> GTTTCTGCCGACGTTGACC
CGATATAAGTCACTGTACC -> GATATAAGTCACTGTACCG
GCTTCTGGGTGACATCTTT -> CTTCTGGGTGACATCTTTG
CAGTGCATCCAATTAGCCG -> AGTGCATCCAATTAGCCGT
ACATCGGCGGAGTAAATGA -> CATCGGCGGAGTAAATGAT
AACGGGGCCTAATACCCCC -> ACGGGGCCTAATACCCCCT
CATTAATCTGCTCTGATCT -> ATTAATCTGCTCTGATCTT
AACGGGACCGCCCATGTAC -> ACGGGACCGCCCATGTACG
TTATCCATCAGACACCCTT -> TATCCATCAGACACCCTTG
GCAGACAGTGCATCCAATT -> CAGACAGTGCATCCAATTA
TAGATGCGAAGACTTGTTG -> AGATGCGAAGACTTGTTGA
ACAATGTTCCCCAGCAAAA -> CAATGTTCCCCAGCAAAAT
ATCCATCAGACACCCTTGG -> TCCATCAGACACCCTTGGA
ACGGACCCGGAAAATATAG -> CGGACCCGGAAAATATAGA
CCTGCTTCTTATCGCCTTT -> CTGCTTCTTATCGCCTTTG
ACAAACCTGCGTGCTTACT -> CAAACCTGCGTGCTTACTA
TTCGTTCATCGGAGAGGCT -> TCGTTCATCGGAGAGGCTC
ATCAAAGTTCAGATTGGAC -> TCAAAGTTCAGATTGGACG
ATAGTTAAGATCCTTTACA -> TAGTTAAGATCCTTTACAT
CATTTCCCGGGCCCCTCGA -> ATTTCCCGGGCCCCTCGAT
CCTTGGACGTACTGTACCG -> CTTGGACGTACTGTACCGG
GTCAAATCTCCTCAACATA -> TCAAATCTCCTCAACATAA
GGCACATTTCCCGGGCCCC -> GCACATTTCCCGGGCCCCT
ATGACGTGACGATCAGGGA -> TGACGTGACGATCAGGGAA
GAGGCTCCCATTGATTGGT -> AGGCTCCCATTGATTGGTA
TGGAATTCAAGAAGGAGGC -> GGAATTCAAGAAGGAGGCT
TAGGGAGCTCCTTTAGCTA -> AGGGAGCTCCTTTAGCTAA
CCAATTAGCCGTCCTATCC -> CAATTAGCCGTCCTATCCG
GCTCTGATCTTAGAGGATC -> CTCTGATCTTAGAGGATCG
CATCTTTGTTTCACGCGAA -> ATCTTTGTTTCACGCGAAG
GTCTAGATATGGCAGACAG -> TCTAGATATGGCAGACAGT
TTGACTGACAATGTTCCCC -> TGACTGACAATGTTCCCCA
CAGAGACAGGTGTCGCGGC -> AGAGACAGGTGTCGCGGCG
ACCCGGGGCCCGCTTCCCA -> CCCGGGGCCCGCTTCCCAG
CCAGCGCGTAATTTACGGC -> CAGCGCGTAATTTACGGCG
AAGCGGCTTCAGCGCGTCG -> AGCGGCTTCAGCGCGTCGA
GGCAACTCCGATATACAAA -> GCAACTCCGATATACAAAG
GTTTTAGGGAGTCAAGTGG -> TTTTAGGGAGTCAAGTGGC
AGTCCGCCGAATCCGGAAG -> GTCCGCCGAATCCGGAAGT
GAATGAGACAGACCGGGAA -> AATGAGACAGACCGGGAAT
GACCGTTATTGATCCATAG -> ACCGTTATTGATCCATAGG
CCCGCTTCCCAGTATACAT -> CCGCTTCCCAGTATACATG
CCGAGCTTCCCTAACTCCC -> CGAGCTTCCCTAACTCCCC
CCTTTACGAGCGGCACCTA -> CTTTACGAGCGGCACCTAC
TTCCCGGGCCCCTCGATTC -> TCCCGGGCCCCTCGATTCC
CAGGGAAGATCTTTTGGTT -> AGGGAAGATCTTTTGGTTC
CTAGGGAGCTCCTTTAGCT -> TAGGGAGCTCCTTTAGCTA
GCACATTTCCCGGGCCCCT -> CACATTTCCCGGGCCCCTC
CATAGGGCGTCCATAATGT -> ATAGGGCGTCCATAATGTT
TCCAGGCTTAGGTAACCCG -> CCAGGCTTAGGTAACCCGG
AGTAACTTCGATTTTGACT -> GTAACTTCGATTTTGACTG
GATGCCTCTAGCCCCAGGG -> ATGCCTCTAGCCCCAGGGC
ATGGAATTCAAGAAGGAGG -> TGGAATTCAAGAAGGAGGC
CGTTCATCGGAGAGGCTCC -> GTTCATCGGAGAGGCTCCC
ATTGGTAGAAACAACTGCC -> TTGGTAGAAACAACTGCCG
CGTAACTCGACACAGCTCC -> GTAACTCGACACAGCTCCC
TGGACGATCTGATGACCCG -> GGACGATCTGATGACCCGT
TAACCCGGGGCCCGCTTCC -> AACCCGGGGCCCGCTTCCC
CTTGTCGGCTGTACCGGTC -> TTGTCGGCTGTACCGGTCG
TGTCGCGGCGAGGCACATT -> GTCGCGGCGAGGCACATTT
CCAGGGCCGACTGAGGATA -> CAGGGCCGACTGAGGATAA
TAGTGGGTCTAGGGAGCTC -> AGTGGGTCTAGGGAGCTCC
TGTGGCACTTTGCAGCGAT -> GTGGCACTTTGCAGCGATC
CCGAAACCCTGAACTTGAG -> CGAAACCCTGAACTTGAGG
GCAAACGCCTCTAAACGGA -> CAAACGCCTCTAAACGGAT
TGGACAGTGGCACACCTGC -> GGACAGTGGCACACCTGCT
TCAGACACGATATAAGTCA -> CAGACACGATATAAGTCAC
CGCGTAATTTACGGCGTCA -> GCGTAATTTACGGCGTCAT
GATAGTGGGTCTAGGGAGC -> ATAGTGGGTCTAGGGAGCT
CGATCCGATTGATGCACGG -> GATCCGATTGATGCACGGA
TTACGAGCGGCACCTACCC -> TACGAGCGGCACCTACCCT
GGGCCCGAAGTGAGGAAGT -> GGCCCGAAGTGAGGAAGTC
CGATGAACCTATATGCGAA -> GATGAACCTATATGCGAAA
CCGCCCATGTACGATCTAC -> CGCCCATGTACGATCTACT
GTCGCGGCGAGGCACATTT -> TCGCGGCGAGGCACATTTC
GATGCACGGACAAAGTCTG -> ATGCACGGACAAAGTCTGG
TCAGTACCCTAACTGCGGG -> CAGTACCCTAACTGCGGGT
GGTTAGATGCGAAGACTTG -> GTTAGATGCGAAGACTTGT
GCATTAATGACTACGCATG -> CATTAATGACTACGCATGG
CCGGCCGGGACACAAACCT -> CGGCCGGGACACAAACCTG
TTGACCAATCCCCATAGGC -> TGACCAATCCCCATAGGCA
GTGGCACACCTGCTTCTTA -> TGGCACACCTGCTTCTTAT
TCAGCTCAACTAAACCATT -> CAGCTCAACTAAACCATTA
CGGTCGCATTAATCTGCTC -> GGTCGCATTAATCTGCTCT
TTGCACGACTTTATTGCGC -> TGCACGACTTTATTGCGCC
TGGTAGAAACAACTGCCGA -> GGTAGAAACAACTGCCGAT
GTACCGGTCGCATTAATGT -> TACCGGTCGCATTAATGTT
CGAGGGCCAACTTGCGAGC -> GAGGGCCAACTTGCGAGCC
CGGCTGTACCGGTCGCATT -> GGCTGTACCGGTCGCATTA
ATCCCCACACGGCACGATG -> TCCCCACACGGCACGATGC
CTACGCATGGGACTAGTGA -> TACGCATGGGACTAGTGAA
TCCCTAACTCCCCTATAAA -> CCCTAACTCCCCTATAAAA
CTTACTAACTCCGAAACCC -> TTACTAACTCCGAAACCCT
AATGTTCGCGATGGCTACC -> ATGTTCGCGATGGCTACCT
CGTTATTGATCCATAGGGC -> GTTATTGATCCATAGGGCG
ATCCATTCCCTGGGCTCTC -> TCCATTCCCTGGGCTCTCC
AGTTGACTTTGCTAGCTCT -> GTTGACTTTGCTAGCTCTG
CGTTTTCGACAATAAGTCG -> GTTTTCGACAATAAGTCGA
TTGGTAGAAACAACTGCCG -> TGGTAGAAACAACTGCCGA
AAAGCAAGCCGCTATGGTT -> AAGCAAGCCGCTATGGTTT
GCGCCAAGCGGCTTCAGCG -> CGCCAAGCGGCTTCAGCGC
GGGCCCCTCGATTCCAGGT -> GGCCCCTCGATTCCAGGTC
GGAAGCCGCTGTAATGGAA -> GAAGCCGCTGTAATGGAAT
TTAATCTGCTCTGATCTTA -> TAATCTGCTCTGATCTTAG
GTCACTGTACCGGTCGCAT -> TCACTGTACCGGTCGCATT
TCTAAACGGATAGGGCCCG -> CTAAACGGATAGGGCCCGA
ATCCCTTTGTGGCTCGTAA -> TCCCTTTGTGGCTCGTAAC
AGGCGATACCCATTATCCA -> GGCGATACCCATTATCCAT
ATACCCATTATCCATCAGA -> TACCCATTATCCATCAGAC
TTTCGGAAGTAACTTCGAT -> TTCGGAAGTAACTTCGATT
ATTAGAGGGAATGAGACAG -> TTAGAGGGAATGAGACAGA
GTCAGCTCAACTAAACCAT -> TCAGCTCAACTAAACCATT
ACTTTATTGCGCCAAGCGG -> CTTTATTGCGCCAAGCGGC
TCGGAAGTAACTTCGATTT -> CGGAAGTAACTTCGATTTT
CACCTACCCTCAGTACCCT -> ACCTACCCTCAGTACCCTA
CTGCTTCTTATCGCCTTTG -> TGCTTCTTATCGCCTTTGG
GCACGACTTTATTGCGCCA -> CACGACTTTATTGCGCCAA
TGGGCTCTCCGAAGTGATG -> GGGCTCTCCGAAGTGATGG
CAGAGTTTATGAGTATGTG -> AGAGTTTATGAGTATGTGC
CGATCTCCTTTTGACCAAT -> GATCTCCTTTTGACCAATC
TCTGTTGTTGTTAAAGACT -> CTGTTGTTGTTAAAGACTG
CCCCTATAAAAATCCATTC -> CCCTATAAAAATCCATTCC
GCGAAATCAGAATATGAAA -> CGAAATCAGAATATGAAAT
CCGCTGTAATGGAATTCAA -> CGCTGTAATGGAATTCAAG
TCAACGTTTTAGGGAGTCA -> CAACGTTTTAGGGAGTCAA
TGCCGATCACGGACTGGCT -> GCCGATCACGGACTGGCTT
TAATGTTCGCGATGGCTAC -> AATGTTCGCGATGGCTACC
GATATACAAAGAGATCCGA -> ATATACAAAGAGATCCGAT
CGAGCTTCCCTAACTCCCC -> GAGCTTCCCTAACTCCCCT
GTAGAAAAATACGTTTTCG -> TAGAAAAATACGTTTTCGA
TCACTAGTCCGCCGAATCC -> CACTAGTCCGCCGAATCCG
CTGTACCGGTCGCATTAAT -> TGTACCGGTCGCATTAATC,TGTACCGGTCGCATTAATC,TGTACCGGTCGCATTAATG,TGTACCGGTCGCATTAATG
GAGGGAGTAGAAAAATACG -> AGGGAGTAGAAAAATACGT
CCTTTCCGCCGAAAATCCC -> CTTTCCGCCGAAAATCCCT
TCCTTTACATAAGGGTATG -> CCTTTACATAAGGGTATGG
GAAGCCGCTGTAATGGAAT -> AAGCCGCTGTAATGGAATT
ATAAGTCGATCCGATTGAT -> TAAGTCGATCCGATTGATG
TCTGATGACCCGTGCGAAA -> CTGATGACCCGTGCGAAAG
ATCCTTTACATAAGGGTAT -> TCCTTTACATAAGGGTATG
TGTTTCGGAAGTAACTTCG -> GTTTCGGAAGTAACTTCGA
ACCTGTGGCACTTTGCAGC -> CCTGTGGCACTTTGCAGCG
TCTACATCGGCGGAGTAAA -> CTACATCGGCGGAGTAAAT
ACTAGTGAAGTTGACTTTG -> CTAGTGAAGTTGACTTTGC
CATTATCCATCAGACACCC -> ATTATCCATCAGACACCCT
GGGAAGATCTTTTGGTTCC -> GGAAGATCTTTTGGTTCCG
TTTCACGCGAAGATTTCTC -> TTCACGCGAAGATTTCTCC
GATTGGTCCCATATTGCCG -> ATTGGTCCCATATTGCCGT
GCCGACGTTGACCTGTGGC -> CCGACGTTGACCTGTGGCA
TTCTGCCGACGTTGACCTG -> TCTGCCGACGTTGACCTGT
AAGTTTAGGTAACAGAGTT -> AGTTTAGGTAACAGAGTTT
GCCGATGAACCTATATGCG -> CCGATGAACCTATATGCGA
ACTCCGATATACAAAGAGA -> CTCCGATATACAAAGAGAT
CAGACCGGGAATGCCGATC -> AGACCGGGAATGCCGATCA
AGTTTATGAGTATGTGCGA -> GTTTATGAGTATGTGCGAG
CGAAGCGGTTTGAAACGTC -> GAAGCGGTTTGAAACGTCC
TCGATCCGATTGATGCACG -> CGATCCGATTGATGCACGG
TCGCATTAATGACTACGCA -> CGCATTAATGACTACGCAT
TAATCCCCACACGGCACGA -> AATCCCCACACGGCACGAT
CAGTAGTCCTTTCCGCCGA -> AGTAGTCCTTTCCGCCGAA
CTTCCCAGTATACATGTTA -> TTCCCAGTATACATGTTAA
CTTCGTAACTCGACACAGC -> TTCGTAACTCGACACAGCT
AAATGATTGGTCCCATATT -> AATGATTGGTCCCATATTG
TGAGGGAGTAGAAAAATAC -> GAGGGAGTAGAAAAATACG
CGCTCCGTTTAGCCCCGGT -> GCTCCGTTTAGCCCCGGTC
GTACTCAATGGATGACAGT -> TACTCAATGGATGACAGTG
ATGTTTAACGGACCCGGAA -> TGTTTAACGGACCCGGAAA
GGGACACAAACCTGCGTGC -> GGACACAAACCTGCGTGCT
ACCAGCTCGATCTCCTTTT -> CCAGCTCGATCTCCTTTTG
TACCCTAACTGCGGGTCGG -> ACCCTAACTGCGGGTCGGG
GGGGAGGAAGCCGCTGTAA -> GGGAGGAAGCCGCTGTAAT
CATAAGGGTATGGGGAGGA -> ATAAGGGTATGGGGAGGAA
CCCGCCCGTTAGCATGTCA -> CCGCCCGTTAGCATGTCAG
AAACCGAGCTTCCCTAACT -> AACCGAGCTTCCCTAACTC
TTAGCCCCGGTCACGCGTC -> TAGCCCCGGTCACGCGTCT
TTGTACTCAATGGATGACA -> TGTACTCAATGGATGACAG
CGTACTGTACCGGTCGCAT -> GTACTGTACCGGTCGCATT
CGTGCTTACTAACTCCGAA -> GTGCTTACTAACTCCGAAA
CTCTAGCCCCAGGGCCGAC -> TCTAGCCCCAGGGCCGACT
CTTGTTGATCGGACCTATG -> TTGTTGATCGGACCTATGG
ACACGATATAAGTCACTGT -> CACGATATAAGTCACTGTA
CCTATGTTTAACGGACCCG -> CTATGTTTAACGGACCCGG
CGACAATAAGTCGATCCGA -> GACAATAAGTCGATCCGAT
TTTAGGGAGTCAAGTGGCC -> TTAGGGAGTCAAGTGGCCT
CAGGCTTAGGTAACCCGGG -> AGGCTTAGGTAACCCGGGG
ACTTGCGAGCCGCTTCTGG -> CTTGCGAGCCGCTTCTGGG
CGCCTTTGGACGGTTACTT -> GCCTTTGGACGGTTACTTT
TCGCCTTTGGACGGTTACT -> CGCCTTTGGACGGTTACTT
ACGTTTTAGGGAGTCAAGT -> CGTTTTAGGGAGTCAAGTG
ACGTAAAGCAAGCCGCTAT -> CGTAAAGCAAGCCGCTATG
GGATGACAGTGATACGCAA -> GATGACAGTGATACGCAAA
CAACGTTTTAGGGAGTCAA -> AACGTTTTAGGGAGTCAAG
GGTCTAGGGAGCTCCTTTA -> GTCTAGGGAGCTCCTTTAG
CAATTAGCCGTCCTATCCG -> AATTAGCCGTCCTATCCGG
GATTTGATCGTGGTTGAGG -> ATTTGATCGTGGTTGAGGG
ATTCAAGAAGGAGGCTCCT -> TTCAAGAAGGAGGCTCCTG
AGCGCGTCGAGCTTTTGAT -> GCGCGTCGAGCTTTTGATT
ACGTTGACCTGTGGCACTT -> CGTTGACCTGTGGCACTTT
CCGCTTCCCAGTATACATG -> CGCTTCCCAGTATACATGT
TCTCGTCGAGAGGCGACTG -> CTCGTCGAGAGGCGACTGT
TCGCGGCGAGGCACATTTC -> CGCGGCGAGGCACATTTCC
GCGTCATCCTTCGGGTCGA -> CGTCATCCTTCGGGTCGAA
AGCCCCAGGGCCGACTGAG -> GCCCCAGGGCCGACTGAGG
GTGCTTACTAACTCCGAAA -> TGCTTACTAACTCCGAAAC
TTCGCGATGGCTACCTGAC -> TCGCGATGGCTACCTGACA
ACTGGCTTCCAGGCTTAGG -> CTGGCTTCCAGGCTTAGGT
ACTGAGGATAAATGCTATC -> CTGAGGATAAATGCTATCT
TGTTAATACCCGGCCGGGA -> GTTAATACCCGGCCGGGAC
GAAGTTTAGGTAACAGAGT -> AAGTTTAGGTAACAGAGTT
GCATGGGACTAGTGAAGTT -> CATGGGACTAGTGAAGTTG
CAAAGAGATCCGATGAATA -> AAAGAGATCCGATGAATAG
TCAGCGCGTCGAGCTTTTG -> CAGCGCGTCGAGCTTTTGA
CAGAATATGAAATCGAAGC -> AGAATATGAAATCGAAGCG
TACATCGGCGGAGTAAATG -> ACATCGGCGGAGTAAATGA
CTAAACCATTATCCATCAG -> TAAACCATTATCCATCAGA
ACCGGTCGCATTAATCTGC -> CCGGTCGCATTAATCTGCT
ATATAGAGTCTCTTCGTTC -> TATAGAGTCTCTTCGTTCA
CGTAAAGCAAGCCGCTATG -> GTAAAGCAAGCCGCTATGG
ACAGCTCCCTTGACGTTCA -> CAGCTCCCTTGACGTTCAT
ATGTCAGCTCAACTAAACC -> TGTCAGCTCAACTAAACCA
TGTAATGGAATTCAAGAAG -> GTAATGGAATTCAAGAAGG
ACTGTCTACATCGGCGGAG -> CTGTCTACATCGGCGGAGT
AATAGTTAAGATCCTTTAC -> ATAGTTAAGATCCTTTACA
TAACCGGCCGTCAACGGGA -> AACCGGCCGTCAACGGGAC
CTCCCCTATAAAAATCCAT -> TCCCCTATAAAAATCCATT
GATCGTGGTTGAGGGGTTA -> ATCGTGGTTGAGGGGTTAG
CGCACTTCTTCGTAACTCG -> GCACTTCTTCGTAACTCGA
AACCCCGCCCGTTAGCATG -> ACCCCGCCCGTTAGCATGT
CTTCCAGGCTTAGGTAACC -> TTCCAGGCTTAGGTAACCC
ATCAGAATATGAAATCGAA -> TCAGAATATGAAATCGAAG
CTTTATTGCGCCAAGCGGC -> TTTATTGCGCCAAGCGGCT
CCGATGAATAGTTAAGATC -> CGATGAATAGTTAAGATCC
ACAGGTCTTCCATTATCCA -> CAGGTCTTCCATTATCCAT
GGCACACCTGCTTCTTATC -> GCACACCTGCTTCTTATCG
TAAAGCGACAACCCCGCCC -> AAAGCGACAACCCCGCCCG
TGACCGTTATTGATCCATA -> GACCGTTATTGATCCATAG
CGATATACAAAGAGATCCG -> GATATACAAAGAGATCCGA
TTTGGTTCCGCTCCGTTTA -> TTGGTTCCGCTCCGTTTAG
GATCTTAGAGGATCGGTTA -> ATCTTAGAGGATCGGTTAC
TTAGCATGTCAGCTCAACT -> TAGCATGTCAGCTCAACTA
TTATTGCGCCAAGCGGCTT -> TATTGCGCCAAGCGGCTTC
TTAATCCCCACACGGCACG -> TAATCCCCACACGGCACGA
TTTGTACTCAATGGATGAC -> TTGTACTCAATGGATGACA
AAATTTAAGTTTGGATCAA -> AATTTAAGTTTGGATCAAC
AGTCTGGCTCCAAGTCAAA -> GTCTGGCTCCAAGTCAAAT
CGACTTTATTGCGCCAAGC -> GACTTTATTGCGCCAAGCG
ACGCCTCTAAACGGATAGG -> CGCCTCTAAACGGATAGGG
GGGTGACATCTTTGTTTCA -> GGTGACATCTTTGTTTCAC
TAGTCCGCCGAATCCGGAA -> AGTCCGCCGAATCCGGAAG
ACCCTCAGTACCCTAACTG -> CCCTCAGTACCCTAACTGC
GTAAAGCAAGCCGCTATGG -> TAAAGCAAGCCGCTATGGT
TGACGTGACGATCAGGGAA -> GACGTGACGATCAGGGAAG
ACCGTTATTGATCCATAGG -> CCGTTATTGATCCATAGGG
CCCCTACTCTGGACGATAA -> CCCTACTCTGGACGATAAC
TAGGGAGTCAAGTGGCCTT -> AGGGAGTCAAGTGGCCTTC
CATCGGCGGAGTAAATGAT -> ATCGGCGGAGTAAATGATT
AAATTGTTTCGGAAGTAAC -> AATTGTTTCGGAAGTAACT
ATCAGACACGATATAAGTC -> TCAGACACGATATAAGTCA
TGGCTTCCAGGCTTAGGTA -> GGCTTCCAGGCTTAGGTAA
CAGTACCCTAACTGCGGGT -> AGTACCCTAACTGCGGGTC
TTTTGATTTGATCGTGGTT -> TTTGATTTGATCGTGGTTG
CGCATTAATGACTACGCAT -> GCATTAATGACTACGCATG
GTTTCTCAAAGGTTAGATG -> TTTCTCAAAGGTTAGATGC
CGAGAGGCGACTGTCTACA -> GAGAGGCGACTGTCTACAT
TAGCTAAATTGTTTCGGAA -> AGCTAAATTGTTTCGGAAG
ACTGCCGATGAACCTATAT -> CTGCCGATGAACCTATATG
TCCGATTGATGCACGGACA -> CCGATTGATGCACGGACAA
AAATATAGAGTCTCTTCGT -> AATATAGAGTCTCTTCGTT
GTTGCACGACTTTATTGCG -> TTGCACGACTTTATTGCGC
GGTCGCATTAATGACTACG -> GTCGCATTAATGACTACGC
TTCACGCGAAGATTTCTCC -> TCACGCGAAGATTTCTCCC
AGTAGACCTAATGTGCCGC -> GTAGACCTAATGTGCCGCT
TAGGCACTAGTCTACACAG -> AGGCACTAGTCTACACAGG
GCCCCAGGGCCGACTGAGG -> CCCCAGGGCCGACTGAGGA
TAGCCCCAGGGCCGACTGA -> AGCCCCAGGGCCGACTGAG
ACTAACTCCGAAACCCTGA -> CTAACTCCGAAACCCTGAA
AACTCCGATATACAAAGAG -> ACTCCGATATACAAAGAGA
CCTCCGAAAAAGGCGCGAC -> CTCCGAAAAAGGCGCGACC
GATGCCATTATCCATCAGA -> ATGCCATTATCCATCAGAC
ATTGGTCCCATATTGCCGT -> TTGGTCCCATATTGCCGTT
GCAAGCCGCTATGGTTTCT -> CAAGCCGCTATGGTTTCTC
AATTGTTTCGGAAGTAACT -> ATTGTTTCGGAAGTAACTT
ATCTACTTCCAGTCAGCTC -> TCTACTTCCAGTCAGCTCA
ATTAATGTTGCTCTGTAGT -> TTAATGTTGCTCTGTAGTA
CGACTGAGGATAAATGCTA -> GACTGAGGATAAATGCTAT
CATAACCGGCCGTCAACGG -> ATAACCGGCCGTCAACGGG
GCACTTCTTCGTAACTCGA -> CACTTCTTCGTAACTCGAC
AGGCGCGACCTATGTTTAA -> GGCGCGACCTATGTTTAAC
TATGGTTTCTCAAAGGTTA -> ATGGTTTCTCAAAGGTTAG
GACGATAACAGCCCAGCGC -> ACGATAACAGCCCAGCGCG
CCCCGGTCACGCGTCTCTC -> CCCGGTCACGCGTCTCTCG
ATAACAGCCCAGCGCGTAA -> TAACAGCCCAGCGCGTAAT
ATTGATTGGTAGAAACAAC -> TTGATTGGTAGAAACAACT
CTTTGTTTCACGCGAAGAT -> TTTGTTTCACGCGAAGATT
CACCTGCTTCTTATCGCCT -> ACCTGCTTCTTATCGCCTT
AGGGCCGACTGAGGATAAA -> GGGCCGACTGAGGATAAAT
GAGGCACATTTCCCGGGCC -> AGGCACATTTCCCGGGCCC
ACAACTGCCGATGAACCTA -> CAACTGCCGATGAACCTAT
TGACATCTTTGTTTCACGC -> GACATCTTTGTTTCACGCG
AATCCCTTTGTGGCTCGTA -> ATCCCTTTGTGGCTCGTAA
GTGGCCTTCTACTGGGTGT -> TGGCCTTCTACTGGGTGTA
GGTCGGGCGTTCACTAGTC -> GTCGGGCGTTCACTAGTCC
CCATCAGACACCCTTGGAC -> CATCAGACACCCTTGGACG
CCATCAGACACGATATAAG -> CATCAGACACGATATAAGT
AAGATTTCTCCCCTCCGAA -> AGATTTCTCCCCTCCGAAA
CCCATTGATTGGTAGAAAC -> CCATTGATTGGTAGAAACA
GCTAGCTCTGTTGTTGTTA -> CTAGCTCTGTTGTTGTTAA
CTATAAAAATCCATTCCCT -> TATAAAAATCCATTCCCTG
ATGGTTTCTCAAAGGTTAG -> TGGTTTCTCAAAGGTTAGA
ACGGACTGGCTTCCAGGCT -> CGGACTGGCTTCCAGGCTT
GGCGCGAGTGAAGGCCACG -> GCGCGAGTGAAGGCCACGT
TTAGAGGGAATGAGACAGA -> TAGAGGGAATGAGACAGAC
CCTACTCTGGACGATAACA -> CTACTCTGGACGATAACAG
CCATATTGCCGTTTCTGCC -> CATATTGCCGTTTCTGCCG
TCTCCTCAACATAACCGGC -> CTCCTCAACATAACCGGCC
GGACGGTTACTTTTATGAT -> GACGGTTACTTTTATGATA
CAATAAGTCGATCCGATTG -> AATAAGTCGATCCGATTGA
ATCGGAGAGGCTCCCATTG -> TCGGAGAGGCTCCCATTGA
TCCCATTGATTGGTAGAAA -> CCCATTGATTGGTAGAAAC
CTTCCCTAACTCCCCTATA -> TTCCCTAACTCCCCTATAA
GAACCTATATGCGAAATCA -> AACCTATATGCGAAATCAG
TTAGGGAGTCAAGTGGCCT -> TAGGGAGTCAAGTGGCCTT
AACTTGCGAGCCGCTTCTG -> ACTTGCGAGCCGCTTCTGG
GGCCACGTAAAGCAAGCCG -> GCCACGTAAAGCAAGCCGC
GAGGGAATGAGACAGACCG -> AGGGAATGAGACAGACCGG
CGACACAGCTCCCTTGACG -> GACACAGCTCCCTTGACGT
TAAACCGAGCTTCCCTAAC -> AAACCGAGCTTCCCTAACT
AACGCCTCTAAACGGATAG -> ACGCCTCTAAACGGATAGG
GGACAAAGTCTGGCTCCAA -> GACAAAGTCTGGCTCCAAG
TCTCTTCGTTCATCGGAGA -> CTCTTCGTTCATCGGAGAG
GCTTAGGTAACCCGGGGCC -> CTTAGGTAACCCGGGGCCC
GCGTCCATAATGTTCGCGA -> CGTCCATAATGTTCGCGAT
TTCGGAAGTAACTTCGATT -> TCGGAAGTAACTTCGATTT
GTCTTATAAACCGAGCTTC -> TCTTATAAACCGAGCTTCC
GAAACAACTGCCGATGAAC -> AAACAACTGCCGATGAACC
GAACCAGCTCGATCTCCTT -> AACCAGCTCGATCTCCTTT
TCCAAGTCAAATCTCCTCA -> CCAAGTCAAATCTCCTCAA
TATGGGGAGGAAGCCGCTG -> ATGGGGAGGAAGCCGCTGT
ACACGGCACGATGCCTCTA -> CACGGCACGATGCCTCTAG
GACAGAATTAGAGGGAATG -> ACAGAATTAGAGGGAATGA
TTATCCATCAGACACACCC -> TATCCATCAGACACACCCT
AATCCGGAAGTTTAGGTAA -> ATCCGGAAGTTTAGGTAAC
TTCCGCTCCGTTTAGCCCC -> TCCGCTCCGTTTAGCCCCG
TCTGGACGATAACAGCCCA -> CTGGACGATAACAGCCCAG
CTTTTGATTTGATCGTGGT -> TTTTGATTTGATCGTGGTT
CCCTGAACTTGAGGGAGTA -> CCTGAACTTGAGGGAGTAG
AAGACTGAGGCGATACCCA -> AGACTGAGGCGATACCCAT
AGGGAAGATCTTTTGGTTC -> GGGAAGATCTTTTGGTTCC
GATCGGTTACGTTGCACGA -> ATCGGTTACGTTGCACGAC
ATAGTGGGTCTAGGGAGCT -> TAGTGGGTCTAGGGAGCTC
TTTGGACGGTTACTTTTAT -> TTGGACGGTTACTTTTATG
ATGTGCCGCTTTCTTGATG -> TGTGCCGCTTTCTTGATGC
GCGAGGGCCAACTTGCGAG -> CGAGGGCCAACTTGCGAGC
AGTCTAGATATGGCAGACA -> GTCTAGATATGGCAGACAG
GACGTGACGATCAGGGAAG -> ACGTGACGATCAGGGAAGA
TGTGGCTCGTAACGGGGCC -> GTGGCTCGTAACGGGGCCT
ATCAGGGAAGATCTTTTGG -> TCAGGGAAGATCTTTTGGT
GGTCTTCCATTATCCATCA -> GTCTTCCATTATCCATCAG
GCCTCTAGCCCCAGGGCCG -> CCTCTAGCCCCAGGGCCGA
GCCGTCAACGGGACCGCCC -> CCGTCAACGGGACCGCCCA
ACACACCCTTGTCGGCTGT -> CACACCCTTGTCGGCTGTA
TTCAGCGCGTCGAGCTTTT -> TCAGCGCGTCGAGCTTTTG
GGTCGAACCAGCTCGATCT -> GTCGAACCAGCTCGATCTC
GATACGCAAACGCCTCTAA -> ATACGCAAACGCCTCTAAA
ATCTGCTCTGATCTTAGAG -> TCTGCTCTGATCTTAGAGG
TGATTGGTCCCATATTGCC -> GATTGGTCCCATATTGCCG
GTCCGCCGAATCCGGAAGT -> TCCGCCGAATCCGGAAGTT
CCGCTTTCTTGATGCCATT -> CGCTTTCTTGATGCCATTA
TTTAACGGACCCGGAAAAT -> TTAACGGACCCGGAAAATA
ATGATTGGTCCCATATTGC -> TGATTGGTCCCATATTGCC
CTACATCGGCGGAGTAAAT -> TACATCGGCGGAGTAAATG
GGGTGTAGGCGCGAGTGAA -> GGTGTAGGCGCGAGTGAAG
GAAGACTTGTTGATCGGAC -> AAGACTTGTTGATCGGACC
TGTACTCAATGGATGACAG -> GTACTCAATGGATGACAGT
TCTTCGTAACTCGACACAG -> CTTCGTAACTCGACACAGC
GGTTACTTTTATGATAGTG -> GTTACTTTTATGATAGTGG
ATAAACCGAGCTTCCCTAA -> TAAACCGAGCTTCCCTAAC
GAGTTTATGAGTATGTGCG -> AGTTTATGAGTATGTGCGA
TCGTCGAGAGGCGACTGTC -> CGTCGAGAGGCGACTGTCT
CTTATCGCCTTTGGACGGT -> TTATCGCCTTTGGACGGTT
CATGGACAGTGGCACACCT -> ATGGACAGTGGCACACCTG
GCGCACTTCTTCGTAACTC -> CGCACTTCTTCGTAACTCG
ACCCGGAAAATATAGAGTC -> CCCGGAAAATATAGAGTCT
GCCCCGGTCACGCGTCTCT -> CCCCGGTCACGCGTCTCTC
TTCTTGATGCCATTATCCA -> TCTTGATGCCATTATCCAT
ATTAATCCCCACACGGCAC -> TTAATCCCCACACGGCACG
TTTGTTTCACGCGAAGATT -> TTGTTTCACGCGAAGATTT
AACCTGCGTGCTTACTAAC -> ACCTGCGTGCTTACTAACT
CAACTGCCGATGAACCTAT -> AACTGCCGATGAACCTATA
TGAGGAAGTCTAGATATGG -> GAGGAAGTCTAGATATGGC
GAAAGCGCACTTCTTCGTA -> AAAGCGCACTTCTTCGTAA
CTAGATATGGCAGACAGTG -> TAGATATGGCAGACAGTGC
TACCTGACAGAATTAGAGG -> ACCTGACAGAATTAGAGGG
AACTCCCCTATAAAAATCC -> ACTCCCCTATAAAAATCCA
TGACGATCAGGGAAGATCT -> GACGATCAGGGAAGATCTT
AAGCAAGCCGCTATGGTTT -> AGCAAGCCGCTATGGTTTC
CGTCGAGAGGCGACTGTCT -> GTCGAGAGGCGACTGTCTA
GAAATCGAAGCGGTTTGAA -> AAATCGAAGCGGTTTGAAA
CCGAAAAAGGCGCGACCTA -> CGAAAAAGGCGCGACCTAT
TCAGACACCCTTGGACGTA -> CAGACACCCTTGGACGTAC
AACAGGCTTACCAAAGAAA -> ACAGGCTTACCAAAGAAAG
GAATAGTTAAGATCCTTTA -> AATAGTTAAGATCCTTTAC
GACGATCTGATGACCCGTG -> ACGATCTGATGACCCGTGC
GGGGCCCGCTTCCCAGTAT -> GGGCCCGCTTCCCAGTATA
CAATCCCCATAGGCACTAG -> AATCCCCATAGGCACTAGT
CAGACACCCTTGGACGTAC -> AGACACCCTTGGACGTACT
GAGGCGATACCCATTATCC -> AGGCGATACCCATTATCCA
AAACGGATAGGGCCCGAAG -> AACGGATAGGGCCCGAAGT
TTAATACCCGGCCGGGACA -> TAATACCCGGCCGGGACAC
CCCGTGCGAAAGCGCACTT -> CCGTGCGAAAGCGCACTTC
GTTGACTTTGCTAGCTCTG -> TTGACTTTGCTAGCTCTGT
GGGTCTAGGGAGCTCCTTT -> GGTCTAGGGAGCTCCTTTA
CGCGTCTCTCGTCGAGAGG -> GCGTCTCTCGTCGAGAGGC
ACCGGGAATGCCGATCACG -> CCGGGAATGCCGATCACGG
TGTTCCCCAGCAAAATTTA -> GTTCCCCAGCAAAATTTAA
AAGTGATGGGCAAAACAGG -> AGTGATGGGCAAAACAGGC
AGAAAAATACGTTTTCGAC -> GAAAAATACGTTTTCGACA
ACTTTGCAGCGATCCTTTA -> CTTTGCAGCGATCCTTTAC
CCAGCAAAATTTAAGTTTG -> CAGCAAAATTTAAGTTTGG
AGGGTATGGGGAGGAAGCC -> GGGTATGGGGAGGAAGCCG
CGCCGAATCCGGAAGTTTA -> GCCGAATCCGGAAGTTTAG
ATATGCGAAATCAGAATAT -> TATGCGAAATCAGAATATG
TTGACCGTTATTGATCCAT -> TGACCGTTATTGATCCATA
ATGACCCGTGCGAAAGCGC -> TGACCCGTGCGAAAGCGCA
GAGACAGACCGGGAATGCC -> AGACAGACCGGGAATGCCG
ACCTAATGTGCCGCTTTCT -> CCTAATGTGCCGCTTTCTT
TTCCCAGTATACATGTTAA -> TCCCAGTATACATGTTAAT
GTTTATGAGTATGTGCGAG -> TTTATGAGTATGTGCGAGG
GCCTTCTACTGGGTGTAGG -> CCTTCTACTGGGTGTAGGC
AGCTTTTGATTTGATCGTG -> GCTTTTGATTTGATCGTGG
CCGGGCCCCTCGATTCCAG -> CGGGCCCCTCGATTCCAGG
CCGACTGAGGATAAATGCT -> CGACTGAGGATAAATGCTA
GGAATTCAAGAAGGAGGCT -> GAATTCAAGAAGGAGGCTC
ACTCCGAAACCCTGAACTT -> CTCCGAAACCCTGAACTTG
GTGATGGGCAAAACAGGCT -> TGATGGGCAAAACAGGCTT
TCCTATCCGGCAACTCCGA -> CCTATCCGGCAACTCCGAT
CAACTAAACCATTATCCAT -> AACTAAACCATTATCCATC
GCACGATGCCTCTAGCCCC -> CACGATGCCTCTAGCCCCA
CGGACCCGGAAAATATAGA -> GGACCCGGAAAATATAGAG
GCATTAATGTTGCTCTGTA -> CATTAATGTTGCTCTGTAG
CGAAAATCCCTTTGTGGCT -> GAAAATCCCTTTGTGGCTC
CCCCTCGATTCCAGGTCAT -> CCCTCGATTCCAGGTCATG
GCATTAATCTGCTCTGATC -> CATTAATCTGCTCTGATCT
GGAATGCCGATCACGGACT -> GAATGCCGATCACGGACTG
CCATAGGGCGTCCATAATG -> CATAGGGCGTCCATAATGT
CAAAGTCTGGCTCCAAGTC -> AAAGTCTGGCTCCAAGTCA
CCAATCCCCATAGGCACTA -> CAATCCCCATAGGCACTAG
CGTTCATGCTTGACCGTTA -> GTTCATGCTTGACCGTTAT
TTACATAAGGGTATGGGGA -> TACATAAGGGTATGGGGAG
CCTGACAGAATTAGAGGGA -> CTGACAGAATTAGAGGGAA
CTCTCGTCGAGAGGCGACT -> TCTCGTCGAGAGGCGACTG
ACTGACAATGTTCCCCAGC -> CTGACAATGTTCCCCAGCA
TGAGGGGTTAGAATGACGT -> GAGGGGTTAGAATGACGTG
CGCTTCTGGGTGACATCTT -> GCTTCTGGGTGACATCTTT
AACGTTTTAGGGAGTCAAG -> ACGTTTTAGGGAGTCAAGT
ATGCGAAGACTTGTTGATC -> TGCGAAGACTTGTTGATCG
TACTGGGTGTAGGCGCGAG -> ACTGGGTGTAGGCGCGAGT
AATACCCGGCCGGGACACA -> ATACCCGGCCGGGACACAA
ATGGGTAAAGCGACAACCC -> TGGGTAAAGCGACAACCCC
TGTTAAAGACTGAGGCGAT -> GTTAAAGACTGAGGCGATA
CAACATAACCGGCCGTCAA -> AACATAACCGGCCGTCAAC
ATAGGGCCCGAAGTGAGGA -> TAGGGCCCGAAGTGAGGAA
CTCGATCTCCTTTTGACCA -> TCGATCTCCTTTTGACCAA
TGATCTTAGAGGATCGGTT -> GATCTTAGAGGATCGGTTA
TCTAGGGAGCTCCTTTAGC -> CTAGGGAGCTCCTTTAGCT
TTGTTTCGGAAGTAACTTC -> TGTTTCGGAAGTAACTTCG
CCCGGGGCCCGCTTCCCAG -> CCGGGGCCCGCTTCCCAGT
AATCTCCTCAACATAACCG -> ATCTCCTCAACATAACCGG
AAGTTCAGATTGGACGATC -> AGTTCAGATTGGACGATCT
CTTTGTGGCTCGTAACGGG -> TTTGTGGCTCGTAACGGGG
CCTGAACTTGAGGGAGTAG -> CTGAACTTGAGGGAGTAGA
CTTTAGCTAAATTGTTTCG -> TTTAGCTAAATTGTTTCGG
ATGATGGAACTGTACCGGT -> TGATGGAACTGTACCGGTC
GGCGCGACCTATGTTTAAC -> GCGCGACCTATGTTTAACG
TAGAATGACGTGACGATCA -> AGAATGACGTGACGATCAG
GAGTAGAAAAATACGTTTT -> AGTAGAAAAATACGTTTTC
CCGCCGAAAATCCCTTTGT -> CGCCGAAAATCCCTTTGTG
TAACAGCCCAGCGCGTAAT -> AACAGCCCAGCGCGTAATT
GCCACGTAAAGCAAGCCGC -> CCACGTAAAGCAAGCCGCT
AGATATGGCAGACAGTGCA -> GATATGGCAGACAGTGCAT
CGGCGAGGCACATTTCCCG -> GGCGAGGCACATTTCCCGG
GATCTACTTCCAGTCAGCT -> ATCTACTTCCAGTCAGCTC
GGATAAATGCTATCTTATA -> GATAAATGCTATCTTATAC
AATCCCCATAGGCACTAGT -> ATCCCCATAGGCACTAGTC
GACTGGCTTCCAGGCTTAG -> ACTGGCTTCCAGGCTTAGG
GATCCGATGAATAGTTAAG -> ATCCGATGAATAGTTAAGA
TTTAGCCCCGGTCACGCGT -> TTAGCCCCGGTCACGCGTC
AGATCTTTTGGTTCCGCTC -> GATCTTTTGGTTCCGCTCC
GAAGCGGTTTGAAACGTCC -> AAGCGGTTTGAAACGTCCG
ACCTATGTTTAACGGACCC -> CCTATGTTTAACGGACCCG
AATCCCCACACGGCACGAT -> ATCCCCACACGGCACGATG
CGATCCTTTACGAGCGGCA -> GATCCTTTACGAGCGGCAC
ACGGATAGGGCCCGAAGTG -> CGGATAGGGCCCGAAGTGA
TTGCCGTTTCTGCCGACGT -> TGCCGTTTCTGCCGACGTT
CAGAATTAGAGGGAATGAG -> AGAATTAGAGGGAATGAGA
AATCCATTCCCTGGGCTCT -> ATCCATTCCCTGGGCTCTC
CTCTAAACGGATAGGGCCC -> TCTAAACGGATAGGGCCCG
TCTACTTCCAGTCAGCTCA -> CTACTTCCAGTCAGCTCAG
TAATGGAATTCAAGAAGGA -> AATGGAATTCAAGAAGGAG
TACGTTTTCGACAATAAGT -> ACGTTTTCGACAATAAGTC
ATCCGATTGATGCACGGAC -> TCCGATTGATGCACGGACA
AGGGAGTAGAAAAATACGT -> GGGAGTAGAAAAATACGTT
ATTAGCCGTCCTATCCGGC -> TTAGCCGTCCTATCCGGCA
TGTCAGCTCAACTAAACCA -> GTCAGCTCAACTAAACCAT
TGTAGTAGACCTAATGTGC -> GTAGTAGACCTAATGTGCC
TCCAGGTCATGGACAGTGG -> CCAGGTCATGGACAGTGGC
ACAGGTGTCGCGGCGAGGC -> CAGGTGTCGCGGCGAGGCA
CGTGCGAAAGCGCACTTCT -> GTGCGAAAGCGCACTTCTT
GTTAATACCCGGCCGGGAC -> TTAATACCCGGCCGGGACA
TTATTGATCCATAGGGCGT -> TATTGATCCATAGGGCGTC
CGGCACCTACCCTCAGTAC -> GGCACCTACCCTCAGTACC
CTTATACAGTAGTCCTTTC -> TTATACAGTAGTCCTTTCC
TCTTGATGCCATTATCCAT -> CTTGATGCCATTATCCATC
GGAAGTTTAGGTAACAGAG -> GAAGTTTAGGTAACAGAGT
GATCCGATTGATGCACGGA -> ATCCGATTGATGCACGGAC
GGCGGAGTAAATGATTGGT -> GCGGAGTAAATGATTGGTC
TTGTTGTTAAAGACTGAGG -> TGTTGTTAAAGACTGAGGC
CAGCTCGATCTCCTTTTGA -> AGCTCGATCTCCTTTTGAC
TTTAAGTTTGGATCAACGT -> TTAAGTTTGGATCAACGTT
CTTGAGGGAGTAGAAAAAT -> TTGAGGGAGTAGAAAAATA
TGTACCGGTCGCATTAATC -> GTACCGGTCGCATTAATCC,GTACCGGTCGCATTAATCT
AACAGAGTTTATGAGTATG -> ACAGAGTTTATGAGTATGT
CTTATAAACCGAGCTTCCC -> TTATAAACCGAGCTTCCCT
TGGGTAAAGCGACAACCCC -> GGGTAAAGCGACAACCCCG
CTGCCGACGTTGACCTGTG -> TGCCGACGTTGACCTGTGG
TTCGTAACTCGACACAGCT -> TCGTAACTCGACACAGCTC
GTAAAGCGACAACCCCGCC -> TAAAGCGACAACCCCGCCC
AGCGGCACCTACCCTCAGT -> GCGGCACCTACCCTCAGTA
CCTATATGCGAAATCAGAA -> CTATATGCGAAATCAGAAT
CTCCAAGTCAAATCTCCTC -> TCCAAGTCAAATCTCCTCA
CATTAATGTTGCTCTGTAG -> ATTAATGTTGCTCTGTAGT
AGGAAGCCGCTGTAATGGA -> GGAAGCCGCTGTAATGGAA
AAGATCCTTTACATAAGGG -> AGATCCTTTACATAAGGGT
GCGATCCTTTACGAGCGGC -> CGATCCTTTACGAGCGGCA
CCGTCTTATAAACCGAGCT -> CGTCTTATAAACCGAGCTT
ACATAACCGGCCGTCAACG -> CATAACCGGCCGTCAACGG
GTAGTAGACCTAATGTGCC -> TAGTAGACCTAATGTGCCG
TATGTTTAACGGACCCGGA -> ATGTTTAACGGACCCGGAA
TTGGACGGTTACTTTTATG -> TGGACGGTTACTTTTATGA
CTTTTGACCAATCCCCATA -> TTTTGACCAATCCCCATAG
CCGATGAACCTATATGCGA -> CGATGAACCTATATGCGAA
GCGTTCACTAGTCCGCCGA -> CGTTCACTAGTCCGCCGAA
CACAGCTCCCTTGACGTTC -> ACAGCTCCCTTGACGTTCA
TCAACTAAACCATTATCCA -> CAACTAAACCATTATCCAT
GGCCTTCTACTGGGTGTAG -> GCCTTCTACTGGGTGTAGG
GCGAGCCGCTTCTGGGTGA -> CGAGCCGCTTCTGGGTGAC
AAGTTGACTTTGCTAGCTC -> AGTTGACTTTGCTAGCTCT
TACATGTTAATACCCGGCC -> ACATGTTAATACCCGGCCG
GACAATGTTCCCCAGCAAA -> ACAATGTTCCCCAGCAAAA
GGTCCCATATTGCCGTTTC -> GTCCCATATTGCCGTTTCT
ACTTCCAGTCAGCTCAGAC -> CTTCCAGTCAGCTCAGACG
TTCCAGGTCATGGACAGTG -> TCCAGGTCATGGACAGTGG
AGCCGTCCTATCCGGCAAC -> GCCGTCCTATCCGGCAACT
GAAGTCTAGATATGGCAGA -> AAGTCTAGATATGGCAGAC
TCCTGGGGCCAGAGACAGG -> CCTGGGGCCAGAGACAGGT
GCAACTCCGATATACAAAG -> CAACTCCGATATACAAAGA
ACTAGTCCGCCGAATCCGG -> CTAGTCCGCCGAATCCGGA
TGTAGGCGCGAGTGAAGGC -> GTAGGCGCGAGTGAAGGCC
TCTTATAAACCGAGCTTCC -> CTTATAAACCGAGCTTCCC
GCCGCTTTCTTGATGCCAT -> CCGCTTTCTTGATGCCATT
TTTGACCAATCCCCATAGG -> TTGACCAATCCCCATAGGC
TACCGGTCGCATTAATGTT -> ACCGGTCGCATTAATGTTG
TCAATGGATGACAGTGATA -> CAATGGATGACAGTGATAC
ACCAATCCCCATAGGCACT -> CCAATCCCCATAGGCACTA
ATGCCATTATCCATCAGAC -> TGCCATTATCCATCAGACA
AGACCTAATGTGCCGCTTT -> GACCTAATGTGCCGCTTTC
GGCCCCTCGATTCCAGGTC -> GCCCCTCGATTCCAGGTCA
TCAAAGGTTAGATGCGAAG -> CAAAGGTTAGATGCGAAGA
TGCACGACTTTATTGCGCC -> GCACGACTTTATTGCGCCA
TTCGACAATAAGTCGATCC -> TCGACAATAAGTCGATCCG
CATCAGACACACCCTTGTC -> ATCAGACACACCCTTGTCG
GGAGGCTCCTGGGGCCAGA -> GAGGCTCCTGGGGCCAGAG
TTGATGCCATTATCCATCA -> TGATGCCATTATCCATCAG
CGATGAATAGTTAAGATCC -> GATGAATAGTTAAGATCCT
AGAATATGAAATCGAAGCG -> GAATATGAAATCGAAGCGG
AAGAAAGATATCAAAGTTC -> AGAAAGATATCAAAGTTCA
GTGGCACTTTGCAGCGATC -> TGGCACTTTGCAGCGATCC
GGGCCGACTGAGGATAAAT -> GGCCGACTGAGGATAAATG
TTCTCCCCTCCGAAAAAGG -> TCTCCCCTCCGAAAAAGGC
TTGAGGGAGTAGAAAAATA -> TGAGGGAGTAGAAAAATAC
TCCCATATTGCCGTTTCTG -> CCCATATTGCCGTTTCTGC
TTCGGGTCGAACCAGCTCG -> TCGGGTCGAACCAGCTCGA
CCTCAACATAACCGGCCGT -> CTCAACATAACCGGCCGTC
GGAGCTCCTTTAGCTAAAT -> GAGCTCCTTTAGCTAAATT
GGAAGATCTTTTGGTTCCG -> GAAGATCTTTTGGTTCCGC
TTCTACTGGGTGTAGGCGC -> TCTACTGGGTGTAGGCGCG
ATGAGTATGTGCGAGGGCC -> TGAGTATGTGCGAGGGCCA
GTGAGGAAGTCTAGATATG -> TGAGGAAGTCTAGATATGG
ATGTTGCTCTGTAGTAGAC -> TGTTGCTCTGTAGTAGACC
CAAAGAAAGATATCAAAGT -> AAAGAAAGATATCAAAGTT
ACTGAGGCGATACCCATTA -> CTGAGGCGATACCCATTAT
TTAGATGCGAAGACTTGTT -> TAGATGCGAAGACTTGTTG
TACCGGTCGCATTAATCTG -> ACCGGTCGCATTAATCTGC
CTAACTGCGGGTCGGGCGT -> TAACTGCGGGTCGGGCGTT
TGCCGCTTTCTTGATGCCA -> GCCGCTTTCTTGATGCCAT
GGTGACATCTTTGTTTCAC -> GTGACATCTTTGTTTCACG
GGCTGTACCGGTCGCATTA -> GCTGTACCGGTCGCATTAA
TCCGCCGAATCCGGAAGTT -> CCGCCGAATCCGGAAGTTT
TTCTTATCGCCTTTGGACG -> TCTTATCGCCTTTGGACGG
AAACGTCCGTCTTATAAAC -> AACGTCCGTCTTATAAACC
TGCGAGGGCCAACTTGCGA -> GCGAGGGCCAACTTGCGAG
TCCTTTTGACCAATCCCCA -> CCTTTTGACCAATCCCCAT
CAGCGCGTAATTTACGGCG -> AGCGCGTAATTTACGGCGT
GTTATTGATCCATAGGGCG -> TTATTGATCCATAGGGCGT
CGAAGTGATGGGCAAAACA -> GAAGTGATGGGCAAAACAG
CCGGCAACTCCGATATACA -> CGGCAACTCCGATATACAA
GTTTTCGACAATAAGTCGA -> TTTTCGACAATAAGTCGAT
ATGTTCGCGATGGCTACCT -> TGTTCGCGATGGCTACCTG
AGGGAGCTCCTTTAGCTAA -> GGGAGCTCCTTTAGCTAAA
CGCTGTAATGGAATTCAAG -> GCTGTAATGGAATTCAAGA
TGGCTCCAAGTCAAATCTC -> GGCTCCAAGTCAAATCTCC
AACTCGACACAGCTCCCTT -> ACTCGACACAGCTCCCTTG
CGGGAATGCCGATCACGGA -> GGGAATGCCGATCACGGAC
ACGGGGCCTAATACCCCCT -> CGGGGCCTAATACCCCCTA
CTTACCAAAGAAAGATATC -> TTACCAAAGAAAGATATCA
CAGACACGATATAAGTCAC -> AGACACGATATAAGTCACT
CGATGCCTCTAGCCCCAGG -> GATGCCTCTAGCCCCAGGG
TCCCAGTATACATGTTAAT -> CCCAGTATACATGTTAATA
ATTGCGCCAAGCGGCTTCA -> TTGCGCCAAGCGGCTTCAG
AGAGGCGACTGTCTACATC -> GAGGCGACTGTCTACATCG
CCGTTTAGCCCCGGTCACG -> CGTTTAGCCCCGGTCACGC
ACAGACCGGGAATGCCGAT -> CAGACCGGGAATGCCGATC
TCCTTCGGGTCGAACCAGC -> CCTTCGGGTCGAACCAGCT
TCCGTCTTATAAACCGAGC -> CCGTCTTATAAACCGAGCT
GTTTCTGCCGACGTTGACC -> TTTCTGCCGACGTTGACCT
ATTGATGCACGGACAAAGT -> TTGATGCACGGACAAAGTC
TCCATAGGGCGTCCATAAT -> CCATAGGGCGTCCATAATG
AAATGCTATCTTATACAGT -> AATGCTATCTTATACAGTA
CACGACTTTATTGCGCCAA -> ACGACTTTATTGCGCCAAG
GGGGTTAGAATGACGTGAC -> GGGTTAGAATGACGTGACG
CATATTGCCGTTTCTGCCG -> ATATTGCCGTTTCTGCCGA
CTGAGGCGATACCCATTAT -> TGAGGCGATACCCATTATC
TCCGAAAAAGGCGCGACCT -> CCGAAAAAGGCGCGACCTA
TCCGCCGAAAATCCCTTTG -> CCGCCGAAAATCCCTTTGT
CCAGAGACAGGTGTCGCGG -> CAGAGACAGGTGTCGCGGC
GGTCGCATTAATGTTGCTC -> GTCGCATTAATGTTGCTCT
AGGGAGTCAAGTGGCCTTC -> GGGAGTCAAGTGGCCTTCT
GCGCGTAATTTACGGCGTC -> CGCGTAATTTACGGCGTCA
ACACCTGCTTCTTATCGCC -> CACCTGCTTCTTATCGCCT
CATGTACGATCTACTTCCA -> ATGTACGATCTACTTCCAG
GGGCGTTCACTAGTCCGCC -> GGCGTTCACTAGTCCGCCG
TTCATCGGAGAGGCTCCCA -> TCATCGGAGAGGCTCCCAT
GAGCTCCTTTAGCTAAATT -> AGCTCCTTTAGCTAAATTG
TTTATGAGTATGTGCGAGG -> TTATGAGTATGTGCGAGGG
GATCCATAGGGCGTCCATA -> ATCCATAGGGCGTCCATAA
AACATAACCGGCCGTCAAC -> ACATAACCGGCCGTCAACG
GTAACCCGGGGCCCGCTTC -> TAACCCGGGGCCCGCTTCC
TCTAGCCCCAGGGCCGACT -> CTAGCCCCAGGGCCGACTG
TCCCCAGCAAAATTTAAGT -> CCCCAGCAAAATTTAAGTT
CCCCTCCGAAAAAGGCGCG -> CCCTCCGAAAAAGGCGCGA
GACACTAATGATGGAACTG -> ACACTAATGATGGAACTGT
ACAGCCCAGCGCGTAATTT -> CAGCCCAGCGCGTAATTTA
TGCCTCTAGCCCCAGGGCC -> GCCTCTAGCCCCAGGGCCG
AGAAACAACTGCCGATGAA -> GAAACAACTGCCGATGAAC
CCATTATCCATCAGACACG -> CATTATCCATCAGACACGA
TATCAAAGTTCAGATTGGA -> ATCAAAGTTCAGATTGGAC
CAGCAAAATTTAAGTTTGG -> AGCAAAATTTAAGTTTGGA
AGAAAGATATCAAAGTTCA -> GAAAGATATCAAAGTTCAG
TGTGCCGCTTTCTTGATGC -> GTGCCGCTTTCTTGATGCC
TCTGCTCTGATCTTAGAGG -> CTGCTCTGATCTTAGAGGA
GATCCTTTACATAAGGGTA -> ATCCTTTACATAAGGGTAT
CGGCGGAGTAAATGATTGG -> GGCGGAGTAAATGATTGGT
ATTATCCATCAGACACGAT -> TTATCCATCAGACACGATA
GCGGCTTCAGCGCGTCGAG -> CGGCTTCAGCGCGTCGAGC
GTACCGGTCGCATTAATGA -> TACCGGTCGCATTAATGAC
CCCTTTGTGGCTCGTAACG -> CCTTTGTGGCTCGTAACGG
CAAAATTTAAGTTTGGATC -> AAAATTTAAGTTTGGATCA
GCGAGGCACATTTCCCGGG -> CGAGGCACATTTCCCGGGC
CCTTTACATAAGGGTATGG -> CTTTACATAAGGGTATGGG
GTAGAAACAACTGCCGATG -> TAGAAACAACTGCCGATGA
GACTGAGGATAAATGCTAT -> ACTGAGGATAAATGCTATC
AACTGCCGATGAACCTATA -> ACTGCCGATGAACCTATAT
GCGCGTCGAGCTTTTGATT -> CGCGTCGAGCTTTTGATTT
TACCAAAGAAAGATATCAA -> ACCAAAGAAAGATATCAAA
GTCATGGACAGTGGCACAC -> TCATGGACAGTGGCACACC
CCTGTGGCACTTTGCAGCG -> CTGTGGCACTTTGCAGCGA
CGTTAGCATGTCAGCTCAA -> GTTAGCATGTCAGCTCAAC
CAGGGCCGACTGAGGATAA -> AGGGCCGACTGAGGATAAA
AGGGCGTCCATAATGTTCG -> GGGCGTCCATAATGTTCGC
CCGATCACGGACTGGCTTC -> CGATCACGGACTGGCTTCC
ATGAATAGTTAAGATCCTT -> TGAATAGTTAAGATCCTTT
TCAAATCTCCTCAACATAA -> CAAATCTCCTCAACATAAC
GTTGAGGGGTTAGAATGAC -> TTGAGGGGTTAGAATGACG
GGTCGCATTAATCTGCTCT -> GTCGCATTAATCTGCTCTG
TCAGACACTAATGATGGAA -> CAGACACTAATGATGGAAC
CACGTAAAGCAAGCCGCTA -> ACGTAAAGCAAGCCGCTAT
CGATTGATGCACGGACAAA -> GATTGATGCACGGACAAAG
GTCACGCGTCTCTCGTCGA -> TCACGCGTCTCTCGTCGAG
ATCGGTTACGTTGCACGAC -> TCGGTTACGTTGCACGACT
TATCTTATACAGTAGTCCT -> ATCTTATACAGTAGTCCTT
AGGCGCGAGTGAAGGCCAC -> GGCGCGAGTGAAGGCCACG
AAAGGCGCGACCTATGTTT -> AAGGCGCGACCTATGTTTA
TGAAACGTCCGTCTTATAA -> GAAACGTCCGTCTTATAAA
AACTCCGAAACCCTGAACT -> ACTCCGAAACCCTGAACTT
AGTCACTGTACCGGTCGCA -> GTCACTGTACCGGTCGCAT
ACTAAACCATTATCCATCA -> CTAAACCATTATCCATCAG
CTCCTTTAGCTAAATTGTT -> TCCTTTAGCTAAATTGTTT
AGAGGCTCCCATTGATTGG -> GAGGCTCCCATTGATTGGT
CTGACAGAATTAGAGGGAA -> TGACAGAATTAGAGGGAAT
CTCCCCTCCGAAAAAGGCG -> TCCCCTCCGAAAAAGGCGC
CGCAAACGCCTCTAAACGG -> GCAAACGCCTCTAAACGGA
AAGGCCACGTAAAGCAAGC -> AGGCCACGTAAAGCAAGCC
TAGAGTCTCTTCGTTCATC -> AGAGTCTCTTCGTTCATCG
AGGTCATGGACAGTGGCAC -> GGTCATGGACAGTGGCACA
TTGCTAGCTCTGTTGTTGT -> TGCTAGCTCTGTTGTTGTT
CGGGCCCCTCGATTCCAGG -> GGGCCCCTCGATTCCAGGT
CAAAGTTCAGATTGGACGA -> AAAGTTCAGATTGGACGAT
GTCTACACAGGTCTTCCAT -> TCTACACAGGTCTTCCATT
TAAACGGATAGGGCCCGAA -> AAACGGATAGGGCCCGAAG
AAGTGAGGAAGTCTAGATA -> AGTGAGGAAGTCTAGATAT
TATCCATCAGACACGATAT -> ATCCATCAGACACGATATA
GGCGACTGTCTACATCGGC -> GCGACTGTCTACATCGGCG
GAAACGTCCGTCTTATAAA -> AAACGTCCGTCTTATAAAC
TGGACGTACTGTACCGGTC -> GGACGTACTGTACCGGTCG
CGGCACGATGCCTCTAGCC -> GGCACGATGCCTCTAGCCC
GTTGCTCTGTAGTAGACCT -> TTGCTCTGTAGTAGACCTA
TCTCTCGTCGAGAGGCGAC -> CTCTCGTCGAGAGGCGACT
GTAACGGGGCCTAATACCC -> TAACGGGGCCTAATACCCC
GGGTTAGAATGACGTGACG -> GGTTAGAATGACGTGACGA
GTCGCATTAATGACTACGC -> TCGCATTAATGACTACGCA
GATCACGGACTGGCTTCCA -> ATCACGGACTGGCTTCCAG
ACCCGTGCGAAAGCGCACT -> CCCGTGCGAAAGCGCACTT
TCCCTTTGTGGCTCGTAAC -> CCCTTTGTGGCTCGTAACG
GCCGTCCTATCCGGCAACT -> CCGTCCTATCCGGCAACTC
TCAACGGGACCGCCCATGT -> CAACGGGACCGCCCATGTA
CCTAATACCCCCTACTCTG -> CTAATACCCCCTACTCTGG
GTCGAGCTTTTGATTTGAT -> TCGAGCTTTTGATTTGATC
GGGTCGAACCAGCTCGATC -> GGTCGAACCAGCTCGATCT
CACTTTGCAGCGATCCTTT -> ACTTTGCAGCGATCCTTTA
ATACGTTTTCGACAATAAG -> TACGTTTTCGACAATAAGT
AATGTTGCTCTGTAGTAGA -> ATGTTGCTCTGTAGTAGAC
TATGTGCGAGGGCCAACTT -> ATGTGCGAGGGCCAACTTG
AACCGGCCGTCAACGGGAC -> ACCGGCCGTCAACGGGACC
TCGGAGAGGCTCCCATTGA -> CGGAGAGGCTCCCATTGAT
AATACCCCCTACTCTGGAC -> ATACCCCCTACTCTGGACG
TTCACTAGTCCGCCGAATC -> TCACTAGTCCGCCGAATCC
CAGTGATACGCAAACGCCT -> AGTGATACGCAAACGCCTC
GAGGGCCAACTTGCGAGCC -> AGGGCCAACTTGCGAGCCG
TGAAGGCCACGTAAAGCAA -> GAAGGCCACGTAAAGCAAG
CTCGTCGAGAGGCGACTGT -> TCGTCGAGAGGCGACTGTC
TTATCCATCAGACACTAAT -> TATCCATCAGACACTAATG
ACAATAAGTCGATCCGATT -> CAATAAGTCGATCCGATTG
TAATACCCGGCCGGGACAC -> AATACCCGGCCGGGACACA
CTCCGAAGTGATGGGCAAA -> TCCGAAGTGATGGGCAAAA
CGCTATGGTTTCTCAAAGG -> GCTATGGTTTCTCAAAGGT
GTTAAAGACTGAGGCGATA -> TTAAAGACTGAGGCGATAC
CTCCGAAACCCTGAACTTG -> TCCGAAACCCTGAACTTGA
GCGATACCCATTATCCATC -> CGATACCCATTATCCATCA
TTGTTGATCGGACCTATGG -> TGTTGATCGGACCTATGGG
CACGGACAAAGTCTGGCTC -> ACGGACAAAGTCTGGCTCC
GCTTCAGCGCGTCGAGCTT -> CTTCAGCGCGTCGAGCTTT
AGTGAAGTTGACTTTGCTA -> GTGAAGTTGACTTTGCTAG
GTGACGATCAGGGAAGATC -> TGACGATCAGGGAAGATCT
TCGTTCATCGGAGAGGCTC -> CGTTCATCGGAGAGGCTCC
GTCCATAATGTTCGCGATG -> TCCATAATGTTCGCGATGG
ATCAGACACCCTTGGACGT -> TCAGACACCCTTGGACGTA
AGGAAGTCTAGATATGGCA -> GGAAGTCTAGATATGGCAG
TCTGTAGTAGACCTAATGT -> CTGTAGTAGACCTAATGTG
TGTTTCACGCGAAGATTTC -> GTTTCACGCGAAGATTTCT
TATGGCAGACAGTGCATCC -> ATGGCAGACAGTGCATCCA
CTGGGGCCAGAGACAGGTG -> TGGGGCCAGAGACAGGTGT
GGTCACGCGTCTCTCGTCG -> GTCACGCGTCTCTCGTCGA
CCGGGGCCCGCTTCCCAGT -> CGGGGCCCGCTTCCCAGTA
TACACAGGTCTTCCATTAT -> ACACAGGTCTTCCATTATC
ATTTACGGCGTCATCCTTC -> TTTACGGCGTCATCCTTCG
CTATCCGGCAACTCCGATA -> TATCCGGCAACTCCGATAT
CGTTGCACGACTTTATTGC -> GTTGCACGACTTTATTGCG
CATTATCCATCAGACACAC -> ATTATCCATCAGACACACC
ATCGTGGTTGAGGGGTTAG -> TCGTGGTTGAGGGGTTAGA
GTGAAGTTGACTTTGCTAG -> TGAAGTTGACTTTGCTAGC
CTTTACGAGCGGCACCTAC -> TTTACGAGCGGCACCTACC
TGGCACTTTGCAGCGATCC -> GGCACTTTGCAGCGATCCT
AAAATATAGAGTCTCTTCG -> AAATATAGAGTCTCTTCGT
ACTCTGGACGATAACAGCC -> CTCTGGACGATAACAGCCC
AGGTTAGATGCGAAGACTT -> GGTTAGATGCGAAGACTTG
ACGGTTACTTTTATGATAG -> CGGTTACTTTTATGATAGT
TTTATGATAGTGGGTCTAG -> TTATGATAGTGGGTCTAGG
CATGTTAATACCCGGCCGG -> ATGTTAATACCCGGCCGGG
CTGGGTGACATCTTTGTTT -> TGGGTGACATCTTTGTTTC
ATCCTTCGGGTCGAACCAG -> TCCTTCGGGTCGAACCAGC
GCTCCTGGGGCCAGAGACA -> CTCCTGGGGCCAGAGACAG
TGCTCTGATCTTAGAGGAT -> GCTCTGATCTTAGAGGATC
GTCAGCTCAGACGCGGGTA -> TCAGCTCAGACGCGGGTAA
TGACAGAATTAGAGGGAAT -> GACAGAATTAGAGGGAATG
ATACGCAAACGCCTCTAAA -> TACGCAAACGCCTCTAAAC
TGGAACTGTACCGGTCGCA -> GGAACTGTACCGGTCGCAT
ACAACCCCGCCCGTTAGCA -> CAACCCCGCCCGTTAGCAT
TACCCCCTACTCTGGACGA -> ACCCCCTACTCTGGACGAT
CTTCTGGGTGACATCTTTG -> TTCTGGGTGACATCTTTGT
CCTTTTGACCAATCCCCAT -> CTTTTGACCAATCCCCATA
TGACTTTGCTAGCTCTGTT -> GACTTTGCTAGCTCTGTTG
AATTTACGGCGTCATCCTT -> ATTTACGGCGTCATCCTTC
TAGAAACAACTGCCGATGA -> AGAAACAACTGCCGATGAA
TCGGCGGAGTAAATGATTG -> CGGCGGAGTAAATGATTGG
GGGACTAGTGAAGTTGACT -> GGACTAGTGAAGTTGACTT
CGGTCGCATTAATGACTAC -> GGTCGCATTAATGACTACG
CCTTCGGGTCGAACCAGCT -> CTTCGGGTCGAACCAGCTC
AAACGCCTCTAAACGGATA -> AACGCCTCTAAACGGATAG
CGATCTACTTCCAGTCAGC -> GATCTACTTCCAGTCAGCT
GCTCGATCTCCTTTTGACC -> CTCGATCTCCTTTTGACCA
CTTTCCGCCGAAAATCCCT -> TTTCCGCCGAAAATCCCTT
AAATCAGAATATGAAATCG -> AATCAGAATATGAAATCGA
GAGGCGACTGTCTACATCG -> AGGCGACTGTCTACATCGG
TATGGGTAAAGCGACAACC -> ATGGGTAAAGCGACAACCC
CTCGATTCCAGGTCATGGA -> TCGATTCCAGGTCATGGAC
CTACTGGGTGTAGGCGCGA -> TACTGGGTGTAGGCGCGAG
TAGATATGGCAGACAGTGC -> AGATATGGCAGACAGTGCA
CATTATCCATCAGACACGA -> ATTATCCATCAGACACGAT
CTCTGTTGTTGTTAAAGAC -> TCTGTTGTTGTTAAAGACT
CACGATGCCTCTAGCCCCA -> ACGATGCCTCTAGCCCCAG
ATCCATCAGACACACCCTT -> TCCATCAGACACACCCTTG
CTTTGCTAGCTCTGTTGTT -> TTTGCTAGCTCTGTTGTTG
CTACTTCCAGTCAGCTCAG -> TACTTCCAGTCAGCTCAGA
GTACGATCTACTTCCAGTC -> TACGATCTACTTCCAGTCA
CGAGCTTTTGATTTGATCG -> GAGCTTTTGATTTGATCGT
CTAACTCCCCTATAAAAAT -> TAACTCCCCTATAAAAATC
TTTAGGTAACAGAGTTTAT -> TTAGGTAACAGAGTTTATG
GGTAACAGAGTTTATGAGT -> GTAACAGAGTTTATGAGTA
AAAATTTAAGTTTGGATCA -> AAATTTAAGTTTGGATCAA
ATGAAATCGAAGCGGTTTG -> TGAAATCGAAGCGGTTTGA
CAGATTGGACGATCTGATG -> AGATTGGACGATCTGATGA
AGTCAAATCTCCTCAACAT -> GTCAAATCTCCTCAACATA
GAGATCCGATGAATAGTTA -> AGATCCGATGAATAGTTAA
CGCGAGTGAAGGCCACGTA -> GCGAGTGAAGGCCACGTAA
CTCAACTAAACCATTATCC -> TCAACTAAACCATTATCCA
TAGGGCCCGAAGTGAGGAA -> AGGGCCCGAAGTGAGGAAG
GCGGAGTAAATGATTGGTC -> CGGAGTAAATGATTGGTCC
ACTTTTATGATAGTGGGTC -> CTTTTATGATAGTGGGTCT
CGTCCATAATGTTCGCGAT -> GTCCATAATGTTCGCGATG
AAAGGTTAGATGCGAAGAC -> AAGGTTAGATGCGAAGACT
AGCCGCTGTAATGGAATTC -> GCCGCTGTAATGGAATTCA
TGCGAGCCGCTTCTGGGTG -> GCGAGCCGCTTCTGGGTGA
GGACCTATGGGTAAAGCGA -> GACCTATGGGTAAAGCGAC
CGGGACACAAACCTGCGTG -> GGGACACAAACCTGCGTGC
TGACGTTCATGCTTGACCG -> GACGTTCATGCTTGACCGT
CGCCGAAAATCCCTTTGTG -> GCCGAAAATCCCTTTGTGG
GACACAAACCTGCGTGCTT -> ACACAAACCTGCGTGCTTA
GCCGAATCCGGAAGTTTAG -> CCGAATCCGGAAGTTTAGG
CTGGGTGTAGGCGCGAGTG -> TGGGTGTAGGCGCGAGTGA
TGTTGTTAAAGACTGAGGC -> GTTGTTAAAGACTGAGGCG
TGATGGAACTGTACCGGTC -> GATGGAACTGTACCGGTCG
CAAGCGGCTTCAGCGCGTC -> AAGCGGCTTCAGCGCGTCG
ATTGATCCATAGGGCGTCC -> TTGATCCATAGGGCGTCCA
AAGCCGCTATGGTTTCTCA -> AGCCGCTATGGTTTCTCAA
CCAGGCTTAGGTAACCCGG -> CAGGCTTAGGTAACCCGGG
AATGATGGAACTGTACCGG -> ATGATGGAACTGTACCGGT
GACTTTGCTAGCTCTGTTG -> ACTTTGCTAGCTCTGTTGT
TTCCCTGGGCTCTCCGAAG -> TCCCTGGGCTCTCCGAAGT
CGCCCGTTAGCATGTCAGC -> GCCCGTTAGCATGTCAGCT
GAGTCTCTTCGTTCATCGG -> AGTCTCTTCGTTCATCGGA
AAGGTTAGATGCGAAGACT -> AGGTTAGATGCGAAGACTT
CCAGTCAGCTCAGACGCGG -> CAGTCAGCTCAGACGCGGG
TACTAACTCCGAAACCCTG -> ACTAACTCCGAAACCCTGA
CATCAGACACGATATAAGT -> ATCAGACACGATATAAGTC
GAGCGGCACCTACCCTCAG -> AGCGGCACCTACCCTCAGT
GGAGTCAAGTGGCCTTCTA -> GAGTCAAGTGGCCTTCTAC
GAAGTTGACTTTGCTAGCT -> AAGTTGACTTTGCTAGCTC
CTCCGAAAAAGGCGCGACC -> TCCGAAAAAGGCGCGACCT
AGCATGTCAGCTCAACTAA -> GCATGTCAGCTCAACTAAA
TGATAGTGGGTCTAGGGAG -> GATAGTGGGTCTAGGGAGC
GATATGGCAGACAGTGCAT -> ATATGGCAGACAGTGCATC
CAGACACACCCTTGTCGGC -> AGACACACCCTTGTCGGCT
GACGTACTGTACCGGTCGC -> ACGTACTGTACCGGTCGCA
GGTTGAGGGGTTAGAATGA -> GTTGAGGGGTTAGAATGAC
GTTCGCGATGGCTACCTGA -> TTCGCGATGGCTACCTGAC
CGCGATGGCTACCTGACAG -> GCGATGGCTACCTGACAGA
CGGAAGTTTAGGTAACAGA -> GGAAGTTTAGGTAACAGAG
TACCCGGCCGGGACACAAA -> ACCCGGCCGGGACACAAAC
CCTATCCGGCAACTCCGAT -> CTATCCGGCAACTCCGATA
TTGCGAGCCGCTTCTGGGT -> TGCGAGCCGCTTCTGGGTG
CCAAAGAAAGATATCAAAG -> CAAAGAAAGATATCAAAGT
CTGCGTGCTTACTAACTCC -> TGCGTGCTTACTAACTCCG
CATCAGACACTAATGATGG -> ATCAGACACTAATGATGGA
GTGTAGGCGCGAGTGAAGG -> TGTAGGCGCGAGTGAAGGC
ATGTACGATCTACTTCCAG -> TGTACGATCTACTTCCAGT
CGCTTCCCAGTATACATGT -> GCTTCCCAGTATACATGTT
ATCCGGCAACTCCGATATA -> TCCGGCAACTCCGATATAC
TACGGCGTCATCCTTCGGG -> ACGGCGTCATCCTTCGGGT
TCAGACACACCCTTGTCGG -> CAGACACACCCTTGTCGGC
GTCGGCTGTACCGGTCGCA -> TCGGCTGTACCGGTCGCAT
CTTTTGGTTCCGCTCCGTT -> TTTTGGTTCCGCTCCGTTT
CATGTCAGCTCAACTAAAC -> ATGTCAGCTCAACTAAACC
CTATGGGTAAAGCGACAAC -> TATGGGTAAAGCGACAACC
ACCTGACAGAATTAGAGGG -> CCTGACAGAATTAGAGGGA
CGACGTTGACCTGTGGCAC -> GACGTTGACCTGTGGCACT
GACAATAAGTCGATCCGAT -> ACAATAAGTCGATCCGATT
ATTTGATCGTGGTTGAGGG -> TTTGATCGTGGTTGAGGGG
ATCCAATTAGCCGTCCTAT -> TCCAATTAGCCGTCCTATC
GGCGATACCCATTATCCAT -> GCGATACCCATTATCCATC
GTAACTCGACACAGCTCCC -> TAACTCGACACAGCTCCCT
ACAGAGTTTATGAGTATGT -> CAGAGTTTATGAGTATGTG
GGCTCCAAGTCAAATCTCC -> GCTCCAAGTCAAATCTCCT
CTCGACACAGCTCCCTTGA -> TCGACACAGCTCCCTTGAC
TCATCGGAGAGGCTCCCAT -> CATCGGAGAGGCTCCCATT
AAAGACTGAGGCGATACCC -> AAGACTGAGGCGATACCCA
ATCAGACACTAATGATGGA -> TCAGACACTAATGATGGAA
GCCAACTTGCGAGCCGCTT -> CCAACTTGCGAGCCGCTTC
GGCCGACTGAGGATAAATG -> GCCGACTGAGGATAAATGC
TTGTCGGCTGTACCGGTCG -> TGTCGGCTGTACCGGTCGC
GCCCAGCGCGTAATTTACG -> CCCAGCGCGTAATTTACGG
AGTGAAGGCCACGTAAAGC -> GTGAAGGCCACGTAAAGCA
ACAGTGCATCCAATTAGCC -> CAGTGCATCCAATTAGCCG
ATCCATCAGACACTAATGA -> TCCATCAGACACTAATGAT
ACGCGAAGATTTCTCCCCT -> CGCGAAGATTTCTCCCCTC
TTGGACGTACTGTACCGGT -> TGGACGTACTGTACCGGTC
CGTTCACTAGTCCGCCGAA -> GTTCACTAGTCCGCCGAAT
AGTATGTGCGAGGGCCAAC -> GTATGTGCGAGGGCCAACT
GGTCATGGACAGTGGCACA -> GTCATGGACAGTGGCACAC
TAGTTAAGATCCTTTACAT -> AGTTAAGATCCTTTACATA
AGGATCGGTTACGTTGCAC -> GGATCGGTTACGTTGCACG
CCCAGTATACATGTTAATA -> CCAGTATACATGTTAATAC
GCGTAATTTACGGCGTCAT -> CGTAATTTACGGCGTCATC
GGAAGTCTAGATATGGCAG -> GAAGTCTAGATATGGCAGA
ATGACTACGCATGGGACTA -> TGACTACGCATGGGACTAG
GCCTAATACCCCCTACTCT -> CCTAATACCCCCTACTCTG
CTGTAATGGAATTCAAGAA -> TGTAATGGAATTCAAGAAG
CGCCAAGCGGCTTCAGCGC -> GCCAAGCGGCTTCAGCGCG
CCTTTAGCTAAATTGTTTC -> CTTTAGCTAAATTGTTTCG
CGCGACCTATGTTTAACGG -> GCGACCTATGTTTAACGGA
TCTCAAAGGTTAGATGCGA -> CTCAAAGGTTAGATGCGAA
CTGTAGTAGACCTAATGTG -> TGTAGTAGACCTAATGTGC
AGCCGCTTCTGGGTGACAT -> GCCGCTTCTGGGTGACATC
ATCTCCTCAACATAACCGG -> TCTCCTCAACATAACCGGC
AGTCAAGTGGCCTTCTACT -> GTCAAGTGGCCTTCTACTG
AATGGAATTCAAGAAGGAG -> ATGGAATTCAAGAAGGAGG
ACCCTTGTCGGCTGTACCG -> CCCTTGTCGGCTGTACCGG
ATCTTAGAGGATCGGTTAC -> TCTTAGAGGATCGGTTACG
CGCTTTCTTGATGCCATTA -> GCTTTCTTGATGCCATTAT
GGCTCGTAACGGGGCCTAA -> GCTCGTAACGGGGCCTAAT
AAAGTTCAGATTGGACGAT -> AAGTTCAGATTGGACGATC
CACGCGAAGATTTCTCCCC -> ACGCGAAGATTTCTCCCCT
GGTAGAAACAACTGCCGAT -> GTAGAAACAACTGCCGATG
TGACCAATCCCCATAGGCA -> GACCAATCCCCATAGGCAC
CGCATTAATCTGCTCTGAT -> GCATTAATCTGCTCTGATC
CACATTTCCCGGGCCCCTC -> ACATTTCCCGGGCCCCTCG
CACAGGTCTTCCATTATCC -> ACAGGTCTTCCATTATCCA
ATATCAAAGTTCAGATTGG -> TATCAAAGTTCAGATTGGA
TTGCAGCGATCCTTTACGA -> TGCAGCGATCCTTTACGAG
GTTGACCTGTGGCACTTTG -> TTGACCTGTGGCACTTTGC
GAAGATTTCTCCCCTCCGA -> AAGATTTCTCCCCTCCGAA
TTTGCAGCGATCCTTTACG -> TTGCAGCGATCCTTTACGA
GACTACGCATGGGACTAGT -> ACTACGCATGGGACTAGTG
AATCAGAATATGAAATCGA -> ATCAGAATATGAAATCGAA
TTATGATAGTGGGTCTAGG -> TATGATAGTGGGTCTAGGG
AGGTGTCGCGGCGAGGCAC -> GGTGTCGCGGCGAGGCACA
ATAAGGGTATGGGGAGGAA -> TAAGGGTATGGGGAGGAAG
TCTAGATATGGCAGACAGT -> CTAGATATGGCAGACAGTG
GCTTCCCAGTATACATGTT -> CTTCCCAGTATACATGTTA
CCGAAGTGAGGAAGTCTAG -> CGAAGTGAGGAAGTCTAGA
CTCAGTACCCTAACTGCGG -> TCAGTACCCTAACTGCGGG
TCCGGAAGTTTAGGTAACA -> CCGGAAGTTTAGGTAACAG
TCTACACAGGTCTTCCATT -> CTACACAGGTCTTCCATTA
GGGAGTAGAAAAATACGTT -> GGAGTAGAAAAATACGTTT
GTAATGGAATTCAAGAAGG -> TAATGGAATTCAAGAAGGA
GGCACTAGTCTACACAGGT -> GCACTAGTCTACACAGGTC
CCTGCGTGCTTACTAACTC -> CTGCGTGCTTACTAACTCC
CTCAAAGGTTAGATGCGAA -> TCAAAGGTTAGATGCGAAG
ACCTATATGCGAAATCAGA -> CCTATATGCGAAATCAGAA
GGGTATGGGGAGGAAGCCG -> GGTATGGGGAGGAAGCCGC
GACTTTATTGCGCCAAGCG -> ACTTTATTGCGCCAAGCGG
TCTGATCTTAGAGGATCGG -> CTGATCTTAGAGGATCGGT
ATACAGTAGTCCTTTCCGC -> TACAGTAGTCCTTTCCGCC
GGGTAAAGCGACAACCCCG -> GGTAAAGCGACAACCCCGC
TGGGGAGGAAGCCGCTGTA -> GGGGAGGAAGCCGCTGTAA
AAACCTGCGTGCTTACTAA -> AACCTGCGTGCTTACTAAC
ATGGAACTGTACCGGTCGC -> TGGAACTGTACCGGTCGCA
AAGTTTGGATCAACGTTTT -> AGTTTGGATCAACGTTTTA
ATAAGTCACTGTACCGGTC -> TAAGTCACTGTACCGGTCG
GCGGCGAGGCACATTTCCC -> CGGCGAGGCACATTTCCCG
AAAGAGATCCGATGAATAG -> AAGAGATCCGATGAATAGT
GCCTCTAAACGGATAGGGC -> CCTCTAAACGGATAGGGCC
GGACGATCTGATGACCCGT -> GACGATCTGATGACCCGTG
GCGGTTTGAAACGTCCGTC -> CGGTTTGAAACGTCCGTCT
CAAGCCGCTATGGTTTCTC -> AAGCCGCTATGGTTTCTCA
CACACCTGCTTCTTATCGC -> ACACCTGCTTCTTATCGCC
GAGAGGCGACTGTCTACAT -> AGAGGCGACTGTCTACATC
GTCGCATTAATCCCCACAC -> TCGCATTAATCCCCACACG
TGCATCCAATTAGCCGTCC -> GCATCCAATTAGCCGTCCT
CAAAGGTTAGATGCGAAGA -> AAAGGTTAGATGCGAAGAC
ACGATCTGATGACCCGTGC -> CGATCTGATGACCCGTGCG
CCAAGCGGCTTCAGCGCGT -> CAAGCGGCTTCAGCGCGTC
TCAGATTGGACGATCTGAT -> CAGATTGGACGATCTGATG
GGCTCCCATTGATTGGTAG -> GCTCCCATTGATTGGTAGA
AGAAGGAGGCTCCTGGGGC -> GAAGGAGGCTCCTGGGGCC
TGAATAGTTAAGATCCTTT -> GAATAGTTAAGATCCTTTA
GTGTCGCGGCGAGGCACAT -> TGTCGCGGCGAGGCACATT
CGATCTGATGACCCGTGCG -> GATCTGATGACCCGTGCGA
CCTAATGTGCCGCTTTCTT -> CTAATGTGCCGCTTTCTTG
AGGAGGCTCCTGGGGCCAG -> GGAGGCTCCTGGGGCCAGA
CTCCTCAACATAACCGGCC -> TCCTCAACATAACCGGCCG
GTGCATCCAATTAGCCGTC -> TGCATCCAATTAGCCGTCC
CGCATGGGACTAGTGAAGT -> GCATGGGACTAGTGAAGTT
CCCCAGGGCCGACTGAGGA -> CCCAGGGCCGACTGAGGAT
GATGGCTACCTGACAGAAT -> ATGGCTACCTGACAGAATT
CGGTCACGCGTCTCTCGTC -> GGTCACGCGTCTCTCGTCG
CAACTCCGATATACAAAGA -> AACTCCGATATACAAAGAG
GAGGCTCCTGGGGCCAGAG -> AGGCTCCTGGGGCCAGAGA
GAATCCGGAAGTTTAGGTA -> AATCCGGAAGTTTAGGTAA
GTCGCATTAATCTGCTCTG -> TCGCATTAATCTGCTCTGA
GAAAAAGGCGCGACCTATG -> AAAAAGGCGCGACCTATGT
GACCGCCCATGTACGATCT -> ACCGCCCATGTACGATCTA
GACACAGCTCCCTTGACGT -> ACACAGCTCCCTTGACGTT
TTTTGGTTCCGCTCCGTTT -> TTTGGTTCCGCTCCGTTTA
TGAGTATGTGCGAGGGCCA -> GAGTATGTGCGAGGGCCAA
TACTGTACCGGTCGCATTA -> ACTGTACCGGTCGCATTAA
CCCGGTCACGCGTCTCTCG -> CCGGTCACGCGTCTCTCGT
ATCCCCATAGGCACTAGTC -> TCCCCATAGGCACTAGTCT
GTGGCTCGTAACGGGGCCT -> TGGCTCGTAACGGGGCCTA
TTCCGCCGAAAATCCCTTT -> TCCGCCGAAAATCCCTTTG
TAAAGACTGAGGCGATACC -> AAAGACTGAGGCGATACCC
TCTTTTGGTTCCGCTCCGT -> CTTTTGGTTCCGCTCCGTT
CGATAACAGCCCAGCGCGT -> GATAACAGCCCAGCGCGTA
CTATATGCGAAATCAGAAT -> TATATGCGAAATCAGAATA
GACCTATGTTTAACGGACC -> ACCTATGTTTAACGGACCC
CTATGTTTAACGGACCCGG -> TATGTTTAACGGACCCGGA
ACTTGTTGATCGGACCTAT -> CTTGTTGATCGGACCTATG
TGCTTGACCGTTATTGATC -> GCTTGACCGTTATTGATCC
ATCCGGAAGTTTAGGTAAC -> TCCGGAAGTTTAGGTAACA
ACTTTGCTAGCTCTGTTGT -> CTTTGCTAGCTCTGTTGTT
ACGATCTACTTCCAGTCAG -> CGATCTACTTCCAGTCAGC
AAAGTCTGGCTCCAAGTCA -> AAGTCTGGCTCCAAGTCAA
AGCGCGTAATTTACGGCGT -> GCGCGTAATTTACGGCGTC
CTGATGACCCGTGCGAAAG -> TGATGACCCGTGCGAAAGC
AACTAAACCATTATCCATC -> ACTAAACCATTATCCATCA
CATCCAATTAGCCGTCCTA -> ATCCAATTAGCCGTCCTAT
CGATGGCTACCTGACAGAA -> GATGGCTACCTGACAGAAT
ACATGTTAATACCCGGCCG -> CATGTTAATACCCGGCCGG
CATAGGCACTAGTCTACAC -> ATAGGCACTAGTCTACACA
GTACTGTACCGGTCGCATT -> TACTGTACCGGTCGCATTA
TATGAGTATGTGCGAGGGC -> ATGAGTATGTGCGAGGGCC
CTAACTCCGAAACCCTGAA -> TAACTCCGAAACCCTGAAC
AGACCGGGAATGCCGATCA -> GACCGGGAATGCCGATCAC
CATTCCCTGGGCTCTCCGA -> ATTCCCTGGGCTCTCCGAA
AGTGGCACACCTGCTTCTT -> GTGGCACACCTGCTTCTTA
TATAAGTCACTGTACCGGT -> ATAAGTCACTGTACCGGTC
GGCACTTTGCAGCGATCCT -> GCACTTTGCAGCGATCCTT
TCGAGCTTTTGATTTGATC -> CGAGCTTTTGATTTGATCG
GTTGATCGGACCTATGGGT -> TTGATCGGACCTATGGGTA
CAACCCCGCCCGTTAGCAT -> AACCCCGCCCGTTAGCATG
ACACAGCTCCCTTGACGTT -> CACAGCTCCCTTGACGTTC
TTCATGCTTGACCGTTATT -> TCATGCTTGACCGTTATTG
GCTCCAAGTCAAATCTCCT -> CTCCAAGTCAAATCTCCTC
GCTCTGTTGTTGTTAAAGA -> CTCTGTTGTTGTTAAAGAC
TCAACATAACCGGCCGTCA -> CAACATAACCGGCCGTCAA
GTCAAGTGGCCTTCTACTG -> TCAAGTGGCCTTCTACTGG
GCTAAATTGTTTCGGAAGT -> CTAAATTGTTTCGGAAGTA
AACAACTGCCGATGAACCT -> ACAACTGCCGATGAACCTA
GCTTCTTATCGCCTTTGGA -> CTTCTTATCGCCTTTGGAC
GACTAGTGAAGTTGACTTT -> ACTAGTGAAGTTGACTTTG
GAGAGGCTCCCATTGATTG -> AGAGGCTCCCATTGATTGG
CTCCCTTGACGTTCATGCT -> TCCCTTGACGTTCATGCTT
CCTCTAGCCCCAGGGCCGA -> CTCTAGCCCCAGGGCCGAC
CTTGACCGTTATTGATCCA -> TTGACCGTTATTGATCCAT
GAATGCCGATCACGGACTG -> AATGCCGATCACGGACTGG
ACATTTCCCGGGCCCCTCG -> CATTTCCCGGGCCCCTCGA
TCTACTGGGTGTAGGCGCG -> CTACTGGGTGTAGGCGCGA
GACACGATATAAGTCACTG -> ACACGATATAAGTCACTGT
AGAATTAGAGGGAATGAGA -> GAATTAGAGGGAATGAGAC
GCCGAAAATCCCTTTGTGG -> CCGAAAATCCCTTTGTGGC
GGGCAAAACAGGCTTACCA -> GGCAAAACAGGCTTACCAA
CTGGGCTCTCCGAAGTGAT -> TGGGCTCTCCGAAGTGATG
TTGAAACGTCCGTCTTATA -> TGAAACGTCCGTCTTATAA
TCTCCCCTCCGAAAAAGGC -> CTCCCCTCCGAAAAAGGCG
CGTGGTTGAGGGGTTAGAA -> GTGGTTGAGGGGTTAGAAT
GCTCAACTAAACCATTATC -> CTCAACTAAACCATTATCC
CTTTGGACGGTTACTTTTA -> TTTGGACGGTTACTTTTAT
TCGCATTAATGTTGCTCTG -> CGCATTAATGTTGCTCTGT
GCGAAGACTTGTTGATCGG -> CGAAGACTTGTTGATCGGA
AATGCTATCTTATACAGTA -> ATGCTATCTTATACAGTAG
TTTCTCCCCTCCGAAAAAG -> TTCTCCCCTCCGAAAAAGG
TGCTAGCTCTGTTGTTGTT -> GCTAGCTCTGTTGTTGTTA
CCCTAACTCCCCTATAAAA -> CCTAACTCCCCTATAAAAA
GTGGGTCTAGGGAGCTCCT -> TGGGTCTAGGGAGCTCCTT
ATGAACCTATATGCGAAAT -> TGAACCTATATGCGAAATC
CGAAGATTTCTCCCCTCCG -> GAAGATTTCTCCCCTCCGA
GGCTCCTGGGGCCAGAGAC -> GCTCCTGGGGCCAGAGACA
CGGCCGGGACACAAACCTG -> GGCCGGGACACAAACCTGC
ACTTGAGGGAGTAGAAAAA -> CTTGAGGGAGTAGAAAAAT
TGGGTCTAGGGAGCTCCTT -> GGGTCTAGGGAGCTCCTTT
CTACTCTGGACGATAACAG -> TACTCTGGACGATAACAGC
TTAGCCGTCCTATCCGGCA -> TAGCCGTCCTATCCGGCAA
AAACAGGCTTACCAAAGAA -> AACAGGCTTACCAAAGAAA
AGTGATGGGCAAAACAGGC -> GTGATGGGCAAAACAGGCT
TTTAGCTAAATTGTTTCGG -> TTAGCTAAATTGTTTCGGA
GCGGCACCTACCCTCAGTA -> CGGCACCTACCCTCAGTAC
TTTCTGCCGACGTTGACCT -> TTCTGCCGACGTTGACCTG
CGGGTCGGGCGTTCACTAG -> GGGTCGGGCGTTCACTAGT
GTTCATGCTTGACCGTTAT -> TTCATGCTTGACCGTTATT
TGCTATCTTATACAGTAGT -> GCTATCTTATACAGTAGTC
CCAGCTCGATCTCCTTTTG -> CAGCTCGATCTCCTTTTGA
TTGGTTCCGCTCCGTTTAG -> TGGTTCCGCTCCGTTTAGC
TCTTCCATTATCCATCAGA -> CTTCCATTATCCATCAGAC
TACCGGTCGCATTAATCCC -> ACCGGTCGCATTAATCCCC
CCATTATCCATCAGACACC -> CATTATCCATCAGACACCC
CCGGGAATGCCGATCACGG -> CGGGAATGCCGATCACGGA
TTACGTTGCACGACTTTAT -> TACGTTGCACGACTTTATT
TTGCTCTGTAGTAGACCTA -> TGCTCTGTAGTAGACCTAA
GGACACAAACCTGCGTGCT -> GACACAAACCTGCGTGCTT
TGATCCATAGGGCGTCCAT -> GATCCATAGGGCGTCCATA
TGCGAAGACTTGTTGATCG -> GCGAAGACTTGTTGATCGG
ACCTGCGTGCTTACTAACT -> CCTGCGTGCTTACTAACTC
GATCCTTTACGAGCGGCAC -> ATCCTTTACGAGCGGCACC
AACTGTACCGGTCGCATTA -> ACTGTACCGGTCGCATTAA
CTAGTGAAGTTGACTTTGC -> TAGTGAAGTTGACTTTGCT
CCCTTGGACGTACTGTACC -> CCTTGGACGTACTGTACCG
CGTCTCTCGTCGAGAGGCG -> GTCTCTCGTCGAGAGGCGA
CTAATGATGGAACTGTACC -> TAATGATGGAACTGTACCG
GTAATTTACGGCGTCATCC -> TAATTTACGGCGTCATCCT
GGGCTCTCCGAAGTGATGG -> GGCTCTCCGAAGTGATGGG
TAAGTCGATCCGATTGATG -> AAGTCGATCCGATTGATGC
CGATTTTGACTGACAATGT -> GATTTTGACTGACAATGTT
TCGCGATGGCTACCTGACA -> CGCGATGGCTACCTGACAG
AGAGGATCGGTTACGTTGC -> GAGGATCGGTTACGTTGCA
TTAAAGACTGAGGCGATAC -> TAAAGACTGAGGCGATACC
CGAGGCACATTTCCCGGGC -> GAGGCACATTTCCCGGGCC
ATTGGACGATCTGATGACC -> TTGGACGATCTGATGACCC
GATCTCCTTTTGACCAATC -> ATCTCCTTTTGACCAATCC
ACCATTATCCATCAGACAC -> CCATTATCCATCAGACACA
TGGTTGAGGGGTTAGAATG -> GGTTGAGGGGTTAGAATGA
TTAGGTAACCCGGGGCCCG -> TAGGTAACCCGGGGCCCGC
TCCCCACACGGCACGATGC -> CCCCACACGGCACGATGCC
CGAGCGGCACCTACCCTCA -> GAGCGGCACCTACCCTCAG
GTTAGATGCGAAGACTTGT -> TTAGATGCGAAGACTTGTT
CCGGAAAATATAGAGTCTC -> CGGAAAATATAGAGTCTCT
AATGTTCCCCAGCAAAATT -> ATGTTCCCCAGCAAAATTT
GGCCTAATACCCCCTACTC -> GCCTAATACCCCCTACTCT
GATAAATGCTATCTTATAC -> ATAAATGCTATCTTATACA
TTGACGTTCATGCTTGACC -> TGACGTTCATGCTTGACCG
CCTTGACGTTCATGCTTGA -> CTTGACGTTCATGCTTGAC
GATCGGACCTATGGGTAAA -> ATCGGACCTATGGGTAAAG
TGTTGATCGGACCTATGGG -> GTTGATCGGACCTATGGGT
ACTAGTCTACACAGGTCTT -> CTAGTCTACACAGGTCTTC
AGAGGGAATGAGACAGACC -> GAGGGAATGAGACAGACCG
GCTTCCAGGCTTAGGTAAC -> CTTCCAGGCTTAGGTAACC
TGGCTCGTAACGGGGCCTA -> GGCTCGTAACGGGGCCTAA
GAATTAGAGGGAATGAGAC -> AATTAGAGGGAATGAGACA
GCTGTAATGGAATTCAAGA -> CTGTAATGGAATTCAAGAA
TGCGGGTCGGGCGTTCACT -> GCGGGTCGGGCGTTCACTA
GACGTTGACCTGTGGCACT -> ACGTTGACCTGTGGCACTT
ATGCGAAATCAGAATATGA -> TGCGAAATCAGAATATGAA
CCCATTATCCATCAGACAC -> CCATTATCCATCAGACACC
ACAGTGATACGCAAACGCC -> CAGTGATACGCAAACGCCT
TGGATCAACGTTTTAGGGA -> GGATCAACGTTTTAGGGAG
AAGACTTGTTGATCGGACC -> AGACTTGTTGATCGGACCT
TCCATTATCCATCAGACAC -> CCATTATCCATCAGACACT
GGAAAATATAGAGTCTCTT -> GAAAATATAGAGTCTCTTC
GATGCGAAGACTTGTTGAT -> ATGCGAAGACTTGTTGATC
TAAGTCACTGTACCGGTCG -> AAGTCACTGTACCGGTCGC
GGCGTTCACTAGTCCGCCG -> GCGTTCACTAGTCCGCCGA
CCGGTCGCATTAATGTTGC -> CGGTCGCATTAATGTTGCT
AGTTAAGATCCTTTACATA -> GTTAAGATCCTTTACATAA
CCCTGGGCTCTCCGAAGTG -> CCTGGGCTCTCCGAAGTGA
AGACACCCTTGGACGTACT -> GACACCCTTGGACGTACTG
GACATCTTTGTTTCACGCG -> ACATCTTTGTTTCACGCGA
CGGTCGCATTAATGTTGCT -> GGTCGCATTAATGTTGCTC
CACGGACTGGCTTCCAGGC -> ACGGACTGGCTTCCAGGCT
CCGGTCGCATTAATCCCCA -> CGGTCGCATTAATCCCCAC
GTCGATCCGATTGATGCAC -> TCGATCCGATTGATGCACG
GGATCAACGTTTTAGGGAG -> GATCAACGTTTTAGGGAGT
CAGCCCAGCGCGTAATTTA -> AGCCCAGCGCGTAATTTAC
ATCAACGTTTTAGGGAGTC -> TCAACGTTTTAGGGAGTCA
ACCGCCCATGTACGATCTA -> CCGCCCATGTACGATCTAC
AACCCTGAACTTGAGGGAG -> ACCCTGAACTTGAGGGAGT
AAGAGATCCGATGAATAGT -> AGAGATCCGATGAATAGTT
GATAACAGCCCAGCGCGTA -> ATAACAGCCCAGCGCGTAA
AGACAGACCGGGAATGCCG -> GACAGACCGGGAATGCCGA
AGGCTCCCATTGATTGGTA -> GGCTCCCATTGATTGGTAG
ACGGCGTCATCCTTCGGGT -> CGGCGTCATCCTTCGGGTC
TCTTATCGCCTTTGGACGG -> CTTATCGCCTTTGGACGGT
GTCTCTTCGTTCATCGGAG -> TCTCTTCGTTCATCGGAGA
CACGGCACGATGCCTCTAG -> ACGGCACGATGCCTCTAGC
CACTGTACCGGTCGCATTA -> ACTGTACCGGTCGCATTAA
TTAGAATGACGTGACGATC -> TAGAATGACGTGACGATCA
CCCCACACGGCACGATGCC -> CCCACACGGCACGATGCCT
ATCTGATGACCCGTGCGAA -> TCTGATGACCCGTGCGAAA
AGTCTACACAGGTCTTCCA -> GTCTACACAGGTCTTCCAT
TTAATGACTACGCATGGGA -> TAATGACTACGCATGGGAC
TAGCCGTCCTATCCGGCAA -> AGCCGTCCTATCCGGCAAC
CAAGAAGGAGGCTCCTGGG -> AAGAAGGAGGCTCCTGGGG
GACGTTCATGCTTGACCGT -> ACGTTCATGCTTGACCGTT
CCAACTTGCGAGCCGCTTC -> CAACTTGCGAGCCGCTTCT
GGCGTCATCCTTCGGGTCG -> GCGTCATCCTTCGGGTCGA
AATTAGCCGTCCTATCCGG -> ATTAGCCGTCCTATCCGGC
CTTTACATAAGGGTATGGG -> TTTACATAAGGGTATGGGG
CCACACGGCACGATGCCTC -> CACACGGCACGATGCCTCT
TCAGCTCAGACGCGGGTAA -> CAGCTCAGACGCGGGTAAT
TTGATTTGATCGTGGTTGA -> TGATTTGATCGTGGTTGAG
GAGTCAAGTGGCCTTCTAC -> AGTCAAGTGGCCTTCTACT
AGCTCCCTTGACGTTCATG -> GCTCCCTTGACGTTCATGC
TGACTACGCATGGGACTAG -> GACTACGCATGGGACTAGT
TAATGTGCCGCTTTCTTGA -> AATGTGCCGCTTTCTTGAT
TAGGGCGTCCATAATGTTC -> AGGGCGTCCATAATGTTCG
ACCAAAGAAAGATATCAAA -> CCAAAGAAAGATATCAAAG
TAAGATCCTTTACATAAGG -> AAGATCCTTTACATAAGGG
ACCGGTCGCATTAATCCCC -> CCGGTCGCATTAATCCCCA
TTGGACGATCTGATGACCC -> TGGACGATCTGATGACCCG
AGCTAAATTGTTTCGGAAG -> GCTAAATTGTTTCGGAAGT
GGACTGGCTTCCAGGCTTA -> GACTGGCTTCCAGGCTTAG
GAAAATATAGAGTCTCTTC -> AAAATATAGAGTCTCTTCG
TACTCTGGACGATAACAGC -> ACTCTGGACGATAACAGCC
ATTTAAGTTTGGATCAACG -> TTTAAGTTTGGATCAACGT
GCAAAATTTAAGTTTGGAT -> CAAAATTTAAGTTTGGATC
AGATTGGACGATCTGATGA -> GATTGGACGATCTGATGAC
CGGACCTATGGGTAAAGCG -> GGACCTATGGGTAAAGCGA
CAGTCAGCTCAGACGCGGG -> AGTCAGCTCAGACGCGGGT
AGGCTTACCAAAGAAAGAT -> GGCTTACCAAAGAAAGATA
ATCGAAGCGGTTTGAAACG -> TCGAAGCGGTTTGAAACGT
CCGCTTCTGGGTGACATCT -> CGCTTCTGGGTGACATCTT
GCCCGTTAGCATGTCAGCT -> CCCGTTAGCATGTCAGCTC
TGATCGTGGTTGAGGGGTT -> GATCGTGGTTGAGGGGTTA
TGTCTACATCGGCGGAGTA -> GTCTACATCGGCGGAGTAA
AACTGCGGGTCGGGCGTTC -> ACTGCGGGTCGGGCGTTCA
ACGTCCGTCTTATAAACCG -> CGTCCGTCTTATAAACCGA
AATGCCGATCACGGACTGG -> ATGCCGATCACGGACTGGC
GGAGTAAATGATTGGTCCC -> GAGTAAATGATTGGTCCCA
GTTACTTTTATGATAGTGG -> TTACTTTTATGATAGTGGG
GGGACCGCCCATGTACGAT -> GGACCGCCCATGTACGATC
ACGACTTTATTGCGCCAAG -> CGACTTTATTGCGCCAAGC
CGACTGTCTACATCGGCGG -> GACTGTCTACATCGGCGGA
AGACTGAGGCGATACCCAT -> GACTGAGGCGATACCCATT
ACGATAACAGCCCAGCGCG -> CGATAACAGCCCAGCGCGT
CTATCTTATACAGTAGTCC -> TATCTTATACAGTAGTCCT
GTACCGGTCGCATTAATCT -> TACCGGTCGCATTAATCTG
AGGCTCCTGGGGCCAGAGA -> GGCTCCTGGGGCCAGAGAC
TCCTTTAGCTAAATTGTTT -> CCTTTAGCTAAATTGTTTC
CGACAACCCCGCCCGTTAG -> GACAACCCCGCCCGTTAGC
GACTGACAATGTTCCCCAG -> ACTGACAATGTTCCCCAGC
GAGTGAAGGCCACGTAAAG -> AGTGAAGGCCACGTAAAGC
GCCGCTTCTGGGTGACATC -> CCGCTTCTGGGTGACATCT
AGAGTCTCTTCGTTCATCG -> GAGTCTCTTCGTTCATCGG
TCGAGAGGCGACTGTCTAC -> CGAGAGGCGACTGTCTACA
TAACTTCGATTTTGACTGA -> AACTTCGATTTTGACTGAC
ATTCCCTGGGCTCTCCGAA -> TTCCCTGGGCTCTCCGAAG
TTCGATTTTGACTGACAAT -> TCGATTTTGACTGACAATG
CTCAACATAACCGGCCGTC -> TCAACATAACCGGCCGTCA
GCGACCTATGTTTAACGGA -> CGACCTATGTTTAACGGAC
CGGCTTCAGCGCGTCGAGC -> GGCTTCAGCGCGTCGAGCT
TTGATTGGTAGAAACAACT -> TGATTGGTAGAAACAACTG
GTCGAGAGGCGACTGTCTA -> TCGAGAGGCGACTGTCTAC
CAAAACAGGCTTACCAAAG -> AAAACAGGCTTACCAAAGA
CGGGACCGCCCATGTACGA -> GGGACCGCCCATGTACGAT
ATGGATGACAGTGATACGC -> TGGATGACAGTGATACGCA
CCGATATACAAAGAGATCC -> CGATATACAAAGAGATCCG
GGAACTGTACCGGTCGCAT -> GAACTGTACCGGTCGCATT
GTCTACATCGGCGGAGTAA -> TCTACATCGGCGGAGTAAA
TCCAGTCAGCTCAGACGCG -> CCAGTCAGCTCAGACGCGG
TAATCTGCTCTGATCTTAG -> AATCTGCTCTGATCTTAGA
AATCGAAGCGGTTTGAAAC -> ATCGAAGCGGTTTGAAACG
GGGAGCTCCTTTAGCTAAA -> GGAGCTCCTTTAGCTAAAT
GCTGTACCGGTCGCATTAA -> CTGTACCGGTCGCATTAAT
AATAAGTCGATCCGATTGA -> ATAAGTCGATCCGATTGAT
GAATGACGTGACGATCAGG -> AATGACGTGACGATCAGGG
AGCGCACTTCTTCGTAACT -> GCGCACTTCTTCGTAACTC
CAATGTTCCCCAGCAAAAT -> AATGTTCCCCAGCAAAATT
ACGATCAGGGAAGATCTTT -> CGATCAGGGAAGATCTTTT
TATTGCGCCAAGCGGCTTC -> ATTGCGCCAAGCGGCTTCA
TTTGACTGACAATGTTCCC -> TTGACTGACAATGTTCCCC
CAGACAGTGCATCCAATTA -> AGACAGTGCATCCAATTAG
CCCGGAAAATATAGAGTCT -> CCGGAAAATATAGAGTCTC
GGTTTGAAACGTCCGTCTT -> GTTTGAAACGTCCGTCTTA
CTTTGTACTCAATGGATGA -> TTTGTACTCAATGGATGAC
GCACTTTGCAGCGATCCTT -> CACTTTGCAGCGATCCTTT
AGTGATACGCAAACGCCTC -> GTGATACGCAAACGCCTCT
TTTATTGCGCCAAGCGGCT -> TTATTGCGCCAAGCGGCTT
GGAGTAGAAAAATACGTTT -> GAGTAGAAAAATACGTTTT
TTGTTAAAGACTGAGGCGA -> TGTTAAAGACTGAGGCGAT
TAAGGGTATGGGGAGGAAG -> AAGGGTATGGGGAGGAAGC
CCCCGCCCGTTAGCATGTC -> CCCGCCCGTTAGCATGTCA
TGATGACCCGTGCGAAAGC -> GATGACCCGTGCGAAAGCG
ATGGGGAGGAAGCCGCTGT -> TGGGGAGGAAGCCGCTGTA
CTTCGTTCATCGGAGAGGC -> TTCGTTCATCGGAGAGGCT
TTCCAGGCTTAGGTAACCC -> TCCAGGCTTAGGTAACCCG
CAGGCTTACCAAAGAAAGA -> AGGCTTACCAAAGAAAGAT
TTGAGGGGTTAGAATGACG -> TGAGGGGTTAGAATGACGT
CATGCTTGACCGTTATTGA -> ATGCTTGACCGTTATTGAT
CGGTTACGTTGCACGACTT -> GGTTACGTTGCACGACTTT
CTACACAGGTCTTCCATTA -> TACACAGGTCTTCCATTAT
GGCTTACCAAAGAAAGATA -> GCTTACCAAAGAAAGATAT
CCTAACTGCGGGTCGGGCG -> CTAACTGCGGGTCGGGCGT
ACCGGCCGTCAACGGGACC -> CCGGCCGTCAACGGGACCG
ACCGAGCTTCCCTAACTCC -> CCGAGCTTCCCTAACTCCC
GACCAATCCCCATAGGCAC -> ACCAATCCCCATAGGCACT
TACAAAGAGATCCGATGAA -> ACAAAGAGATCCGATGAAT
ACCTACCCTCAGTACCCTA -> CCTACCCTCAGTACCCTAA
GTCAACGGGACCGCCCATG -> TCAACGGGACCGCCCATGT
TCAAGAAGGAGGCTCCTGG -> CAAGAAGGAGGCTCCTGGG
GAAAGATATCAAAGTTCAG -> AAAGATATCAAAGTTCAGA
TAACTGCGGGTCGGGCGTT -> AACTGCGGGTCGGGCGTTC
TTAGCTAAATTGTTTCGGA -> TAGCTAAATTGTTTCGGAA
GATGACAGTGATACGCAAA -> ATGACAGTGATACGCAAAC
TTATCCATCAGACACGATA -> TATCCATCAGACACGATAT
TTTACATAAGGGTATGGGG -> TTACATAAGGGTATGGGGA
GTATACATGTTAATACCCG -> TATACATGTTAATACCCGG
TTGTTTCACGCGAAGATTT -> TGTTTCACGCGAAGATTTC
ACACAAACCTGCGTGCTTA -> CACAAACCTGCGTGCTTAC
CTTGATGCCATTATCCATC -> TTGATGCCATTATCCATCA
CAGTGGCACACCTGCTTCT -> AGTGGCACACCTGCTTCTT
TAGAGGATCGGTTACGTTG -> AGAGGATCGGTTACGTTGC
CTTTTATGATAGTGGGTCT -> TTTTATGATAGTGGGTCTA
CATGGGACTAGTGAAGTTG -> ATGGGACTAGTGAAGTTGA
AAATCGAAGCGGTTTGAAA -> AATCGAAGCGGTTTGAAAC
GCTCCCATTGATTGGTAGA -> CTCCCATTGATTGGTAGAA
CCGCCCGTTAGCATGTCAG -> CGCCCGTTAGCATGTCAGC
CTAGTCTACACAGGTCTTC -> TAGTCTACACAGGTCTTCC
AAGCCGCTGTAATGGAATT -> AGCCGCTGTAATGGAATTC
GATTGATGCACGGACAAAG -> ATTGATGCACGGACAAAGT
CCGGTCGCATTAATGACTA -> CGGTCGCATTAATGACTAC
GAGTAAATGATTGGTCCCA -> AGTAAATGATTGGTCCCAT
CTGAGGATAAATGCTATCT -> TGAGGATAAATGCTATCTT
GCGAAGATTTCTCCCCTCC -> CGAAGATTTCTCCCCTCCG
CTCTCCGAAGTGATGGGCA -> TCTCCGAAGTGATGGGCAA
CCCTTGACGTTCATGCTTG -> CCTTGACGTTCATGCTTGA
CGGGGCCCGCTTCCCAGTA -> GGGGCCCGCTTCCCAGTAT
AAGTCTAGATATGGCAGAC -> AGTCTAGATATGGCAGACA
TCTTATACAGTAGTCCTTT -> CTTATACAGTAGTCCTTTC
AGACAGGTGTCGCGGCGAG -> GACAGGTGTCGCGGCGAGG
TGGGCAAAACAGGCTTACC -> GGGCAAAACAGGCTTACCA
TGAAGTTGACTTTGCTAGC -> GAAGTTGACTTTGCTAGCT
TTCTCAAAGGTTAGATGCG -> TCTCAAAGGTTAGATGCGA
CCGCTCCGTTTAGCCCCGG -> CGCTCCGTTTAGCCCCGGT
TTTTAGGGAGTCAAGTGGC -> TTTAGGGAGTCAAGTGGCC
TTTGGATCAACGTTTTAGG -> TTGGATCAACGTTTTAGGG
CAACGGGACCGCCCATGTA -> AACGGGACCGCCCATGTAC
CTCTGTAGTAGACCTAATG -> TCTGTAGTAGACCTAATGT
TAAACCATTATCCATCAGA -> AAACCATTATCCATCAGAC
CGTCTTATAAACCGAGCTT -> GTCTTATAAACCGAGCTTC
TGATTTGATCGTGGTTGAG -> GATTTGATCGTGGTTGAGG
CTAATGTGCCGCTTTCTTG -> TAATGTGCCGCTTTCTTGA
TCCCTGGGCTCTCCGAAGT -> CCCTGGGCTCTCCGAAGTG
TAGCATGTCAGCTCAACTA -> AGCATGTCAGCTCAACTAA
TGATCGGACCTATGGGTAA -> GATCGGACCTATGGGTAAA
AGTACCCTAACTGCGGGTC -> GTACCCTAACTGCGGGTCG
CCCACACGGCACGATGCCT -> CCACACGGCACGATGCCTC
CGATTCCAGGTCATGGACA -> GATTCCAGGTCATGGACAG
AGCGGTTTGAAACGTCCGT -> GCGGTTTGAAACGTCCGTC
TACCCATTATCCATCAGAC -> ACCCATTATCCATCAGACA
TCGATTTTGACTGACAATG -> CGATTTTGACTGACAATGT
CCCGGCCGGGACACAAACC -> CCGGCCGGGACACAAACCT
ATCGGACCTATGGGTAAAG -> TCGGACCTATGGGTAAAGC
ATACAAAGAGATCCGATGA -> TACAAAGAGATCCGATGAA
TTTGATCGTGGTTGAGGGG -> TTGATCGTGGTTGAGGGGT
GGCAAAACAGGCTTACCAA -> GCAAAACAGGCTTACCAAA
TTTCTCAAAGGTTAGATGC -> TTCTCAAAGGTTAGATGCG
GGAGAGGCTCCCATTGATT -> GAGAGGCTCCCATTGATTG
ACGTGACGATCAGGGAAGA -> CGTGACGATCAGGGAAGAT
CCATAATGTTCGCGATGGC -> CATAATGTTCGCGATGGCT
AGGGAATGAGACAGACCGG -> GGGAATGAGACAGACCGGG
CTTGCGAGCCGCTTCTGGG -> TTGCGAGCCGCTTCTGGGT
ACCCCCTACTCTGGACGAT -> CCCCCTACTCTGGACGATA
ATACCCCCTACTCTGGACG -> TACCCCCTACTCTGGACGA
CCTACCCTCAGTACCCTAA -> CTACCCTCAGTACCCTAAC
CGTCCTATCCGGCAACTCC -> GTCCTATCCGGCAACTCCG
GGTAAAGCGACAACCCCGC -> GTAAAGCGACAACCCCGCC
TACAGTAGTCCTTTCCGCC -> ACAGTAGTCCTTTCCGCCG
TCTGGCTCCAAGTCAAATC -> CTGGCTCCAAGTCAAATCT
TAAATGCTATCTTATACAG -> AAATGCTATCTTATACAGT
CGGAGAGGCTCCCATTGAT -> GGAGAGGCTCCCATTGATT
GCGATGGCTACCTGACAGA -> CGATGGCTACCTGACAGAA
TGGCCTTCTACTGGGTGTA -> GGCCTTCTACTGGGTGTAG
TCCTTTACGAGCGGCACCT -> CCTTTACGAGCGGCACCTA
GGCCAACTTGCGAGCCGCT -> GCCAACTTGCGAGCCGCTT
ATCTCCTTTTGACCAATCC -> TCTCCTTTTGACCAATCCC
CTGTCTACATCGGCGGAGT -> TGTCTACATCGGCGGAGTA
TGTTTAACGGACCCGGAAA -> GTTTAACGGACCCGGAAAA
ATGCTTGACCGTTATTGAT -> TGCTTGACCGTTATTGATC
GTACCGGTCGCATTAATCC -> TACCGGTCGCATTAATCCC
CACACCCTTGTCGGCTGTA -> ACACCCTTGTCGGCTGTAC
GTTACGTTGCACGACTTTA -> TTACGTTGCACGACTTTAT
CAGGTCTTCCATTATCCAT -> AGGTCTTCCATTATCCATC
GTTAGAATGACGTGACGAT -> TTAGAATGACGTGACGATC
GGACAGTGGCACACCTGCT -> GACAGTGGCACACCTGCTT
GCCCCTCGATTCCAGGTCA -> CCCCTCGATTCCAGGTCAT
CAGCGATCCTTTACGAGCG -> AGCGATCCTTTACGAGCGG
TCATGCTTGACCGTTATTG -> CATGCTTGACCGTTATTGA
CACTAGTCTACACAGGTCT -> ACTAGTCTACACAGGTCTT
GGATAGGGCCCGAAGTGAG -> GATAGGGCCCGAAGTGAGG
AGAGATCCGATGAATAGTT -> GAGATCCGATGAATAGTTA
GAAGTGATGGGCAAAACAG -> AAGTGATGGGCAAAACAGG
CACAAACCTGCGTGCTTAC -> ACAAACCTGCGTGCTTACT
AACAGCCCAGCGCGTAATT -> ACAGCCCAGCGCGTAATTT
GAAGATCTTTTGGTTCCGC -> AAGATCTTTTGGTTCCGCT
GTTTAGCCCCGGTCACGCG -> TTTAGCCCCGGTCACGCGT
CCGTGCGAAAGCGCACTTC -> CGTGCGAAAGCGCACTTCT
TCCATTCCCTGGGCTCTCC -> CCATTCCCTGGGCTCTCCG
CAGGTGTCGCGGCGAGGCA -> AGGTGTCGCGGCGAGGCAC
GTCCGTCTTATAAACCGAG -> TCCGTCTTATAAACCGAGC
TCCATCAGACACGATATAA -> CCATCAGACACGATATAAG
GAGGATAAATGCTATCTTA -> AGGATAAATGCTATCTTAT
AGGATAAATGCTATCTTAT -> GGATAAATGCTATCTTATA
CGATCAGGGAAGATCTTTT -> GATCAGGGAAGATCTTTTG
GGCTTCCAGGCTTAGGTAA -> GCTTCCAGGCTTAGGTAAC
TGCCATTATCCATCAGACA -> GCCATTATCCATCAGACAC
GTAACTTCGATTTTGACTG -> TAACTTCGATTTTGACTGA
CCCATGTACGATCTACTTC -> CCATGTACGATCTACTTCC
GAGGAAGTCTAGATATGGC -> AGGAAGTCTAGATATGGCA
AGGTAACAGAGTTTATGAG -> GGTAACAGAGTTTATGAGT
GACTGTCTACATCGGCGGA -> ACTGTCTACATCGGCGGAG
GTCCTTTCCGCCGAAAATC -> TCCTTTCCGCCGAAAATCC
GATGGGCAAAACAGGCTTA -> ATGGGCAAAACAGGCTTAC
ATGGCAGACAGTGCATCCA -> TGGCAGACAGTGCATCCAA
TGGGTGTAGGCGCGAGTGA -> GGGTGTAGGCGCGAGTGAA
CGTTTTAGGGAGTCAAGTG -> GTTTTAGGGAGTCAAGTGG
GGACTAGTGAAGTTGACTT -> GACTAGTGAAGTTGACTTT
GCGACTGTCTACATCGGCG -> CGACTGTCTACATCGGCGG
CCGTTATTGATCCATAGGG -> CGTTATTGATCCATAGGGC
ACTGGGTGTAGGCGCGAGT -> CTGGGTGTAGGCGCGAGTG
GTTCAGATTGGACGATCTG -> TTCAGATTGGACGATCTGA
CTCTGATCTTAGAGGATCG -> TCTGATCTTAGAGGATCGG
GGCACCTACCCTCAGTACC -> GCACCTACCCTCAGTACCC
GAGCTTCCCTAACTCCCCT -> AGCTTCCCTAACTCCCCTA
AACGGATAGGGCCCGAAGT -> ACGGATAGGGCCCGAAGTG
AGATGCGAAGACTTGTTGA -> GATGCGAAGACTTGTTGAT
ATGCACGGACAAAGTCTGG -> TGCACGGACAAAGTCTGGC
CAGTATACATGTTAATACC -> AGTATACATGTTAATACCC
TTTTGACCAATCCCCATAG -> TTTGACCAATCCCCATAGG
TCGGTTACGTTGCACGACT -> CGGTTACGTTGCACGACTT
ATCCATCAGACACGATATA -> TCCATCAGACACGATATAA
CCCTACTCTGGACGATAAC -> CCTACTCTGGACGATAACA
TGAGACAGACCGGGAATGC -> GAGACAGACCGGGAATGCC
AGCTCCTTTAGCTAAATTG -> GCTCCTTTAGCTAAATTGT
AACCCGGGGCCCGCTTCCC -> ACCCGGGGCCCGCTTCCCA
TACCCTCAGTACCCTAACT -> ACCCTCAGTACCCTAACTG
GGAATGAGACAGACCGGGA -> GAATGAGACAGACCGGGAA
ACCCTAACTGCGGGTCGGG -> CCCTAACTGCGGGTCGGGC
TATCCATCAGACACCCTTG -> ATCCATCAGACACCCTTGG
ACTTCGATTTTGACTGACA -> CTTCGATTTTGACTGACAA
TCACGGACTGGCTTCCAGG -> CACGGACTGGCTTCCAGGC
TGGCACACCTGCTTCTTAT -> GGCACACCTGCTTCTTATC
TGTTCGCGATGGCTACCTG -> GTTCGCGATGGCTACCTGA
ATATTGCCGTTTCTGCCGA -> TATTGCCGTTTCTGCCGAC
TTCCAGTCAGCTCAGACGC -> TCCAGTCAGCTCAGACGCG
AGGGGTTAGAATGACGTGA -> GGGGTTAGAATGACGTGAC
TACTCAATGGATGACAGTG -> ACTCAATGGATGACAGTGA
CTTCAGCGCGTCGAGCTTT -> TTCAGCGCGTCGAGCTTTT
CGGTTTGAAACGTCCGTCT -> GGTTTGAAACGTCCGTCTT
GGCACGATGCCTCTAGCCC -> GCACGATGCCTCTAGCCCC
TATATGCGAAATCAGAATA -> ATATGCGAAATCAGAATAT
CACGCGTCTCTCGTCGAGA -> ACGCGTCTCTCGTCGAGAG
ATATAAGTCACTGTACCGG -> TATAAGTCACTGTACCGGT
GTGCGAGGGCCAACTTGCG -> TGCGAGGGCCAACTTGCGA
TATAAACCGAGCTTCCCTA -> ATAAACCGAGCTTCCCTAA
GCATCCAATTAGCCGTCCT -> CATCCAATTAGCCGTCCTA
TCATCCTTCGGGTCGAACC -> CATCCTTCGGGTCGAACCA
CTTCTTCGTAACTCGACAC -> TTCTTCGTAACTCGACACA
CTCCGTTTAGCCCCGGTCA -> TCCGTTTAGCCCCGGTCAC
TGGATGACAGTGATACGCA -> GGATGACAGTGATACGCAA
TGGTTCCGCTCCGTTTAGC -> GGTTCCGCTCCGTTTAGCC
TACATAAGGGTATGGGGAG -> ACATAAGGGTATGGGGAGG
TGAGGATAAATGCTATCTT -> GAGGATAAATGCTATCTTA
AGCGATCCTTTACGAGCGG -> GCGATCCTTTACGAGCGGC
ACAGTGGCACACCTGCTTC -> CAGTGGCACACCTGCTTCT
CTTCTACTGGGTGTAGGCG -> TTCTACTGGGTGTAGGCGC
TCGACAATAAGTCGATCCG -> CGACAATAAGTCGATCCGA
ATATGAAATCGAAGCGGTT -> TATGAAATCGAAGCGGTTT
GTTCATCGGAGAGGCTCCC -> TTCATCGGAGAGGCTCCCA
ACTTCTTCGTAACTCGACA -> CTTCTTCGTAACTCGACAC
GGCCGTCAACGGGACCGCC -> GCCGTCAACGGGACCGCCC
TTATAAACCGAGCTTCCCT -> TATAAACCGAGCTTCCCTA
CCATTATCCATCAGACACT -> CATTATCCATCAGACACTA
AACTTCGATTTTGACTGAC -> ACTTCGATTTTGACTGACA
GCCGCTATGGTTTCTCAAA -> CCGCTATGGTTTCTCAAAG
GGTTACGTTGCACGACTTT -> GTTACGTTGCACGACTTTA
CTCCTGGGGCCAGAGACAG -> TCCTGGGGCCAGAGACAGG
CTAGTCCGCCGAATCCGGA -> TAGTCCGCCGAATCCGGAA
CCGCCGAATCCGGAAGTTT -> CGCCGAATCCGGAAGTTTA
TAATTTACGGCGTCATCCT -> AATTTACGGCGTCATCCTT
CCCTCAGTACCCTAACTGC -> CCTCAGTACCCTAACTGCG
AATGTGCCGCTTTCTTGAT -> ATGTGCCGCTTTCTTGATG
GCCATTATCCATCAGACAC -> CCATTATCCATCAGACACG
CGGTCGCATTAATCCCCAC -> GGTCGCATTAATCCCCACA
AGTATACATGTTAATACCC -> GTATACATGTTAATACCCG
GTTCACTAGTCCGCCGAAT -> TTCACTAGTCCGCCGAATC
TAATACCCCCTACTCTGGA -> AATACCCCCTACTCTGGAC
CCCGTTAGCATGTCAGCTC -> CCGTTAGCATGTCAGCTCA
TACGATCTACTTCCAGTCA -> ACGATCTACTTCCAGTCAG
AGTGGGTCTAGGGAGCTCC -> GTGGGTCTAGGGAGCTCCT
CTAATACCCCCTACTCTGG -> TAATACCCCCTACTCTGGA
GATTTTGACTGACAATGTT -> ATTTTGACTGACAATGTTC
TTTCGACAATAAGTCGATC -> TTCGACAATAAGTCGATCC
CATTAATCCCCACACGGCA -> ATTAATCCCCACACGGCAC
CGCATTAATCCCCACACGG -> GCATTAATCCCCACACGGC
CGAATCCGGAAGTTTAGGT -> GAATCCGGAAGTTTAGGTA
AGATCCTTTACATAAGGGT -> GATCCTTTACATAAGGGTA
AAAGATATCAAAGTTCAGA -> AAGATATCAAAGTTCAGAT
AATACGTTTTCGACAATAA -> ATACGTTTTCGACAATAAG
ATCGGCGGAGTAAATGATT -> TCGGCGGAGTAAATGATTG
AAACCCTGAACTTGAGGGA -> AACCCTGAACTTGAGGGAG
TGACTGACAATGTTCCCCA -> GACTGACAATGTTCCCCAG
TCTCCTTTTGACCAATCCC -> CTCCTTTTGACCAATCCCC
CCTCTAAACGGATAGGGCC -> CTCTAAACGGATAGGGCCC
TCGGGTCGAACCAGCTCGA -> CGGGTCGAACCAGCTCGAT
TGGACGATAACAGCCCAGC -> GGACGATAACAGCCCAGCG
GAAATCAGAATATGAAATC -> AAATCAGAATATGAAATCG
GACTGAGGCGATACCCATT -> ACTGAGGCGATACCCATTA
CACCCTTGGACGTACTGTA -> ACCCTTGGACGTACTGTAC
GTTTCACGCGAAGATTTCT -> TTTCACGCGAAGATTTCTC
TCGGACCTATGGGTAAAGC -> CGGACCTATGGGTAAAGCG
GGGCCCGCTTCCCAGTATA -> GGCCCGCTTCCCAGTATAC
AGGCACTAGTCTACACAGG -> GGCACTAGTCTACACAGGT
TTGATCCATAGGGCGTCCA -> TGATCCATAGGGCGTCCAT
CAACTTGCGAGCCGCTTCT -> AACTTGCGAGCCGCTTCTG
GTCTGGCTCCAAGTCAAAT -> TCTGGCTCCAAGTCAAATC
GATTGGTAGAAACAACTGC -> ATTGGTAGAAACAACTGCC
GTATGGGGAGGAAGCCGCT -> TATGGGGAGGAAGCCGCTG
TCCGAAGTGATGGGCAAAA -> CCGAAGTGATGGGCAAAAC
GACCGGGAATGCCGATCAC -> ACCGGGAATGCCGATCACG
TGCGCCAAGCGGCTTCAGC -> GCGCCAAGCGGCTTCAGCG
GTTTAGGTAACAGAGTTTA -> TTTAGGTAACAGAGTTTAT
TATACAAAGAGATCCGATG -> ATACAAAGAGATCCGATGA
CGCGAAGATTTCTCCCCTC -> GCGAAGATTTCTCCCCTCC
GTCCTATCCGGCAACTCCG -> TCCTATCCGGCAACTCCGA
GGGCCAACTTGCGAGCCGC -> GGCCAACTTGCGAGCCGCT
TTCAGATTGGACGATCTGA -> TCAGATTGGACGATCTGAT
TCCATAATGTTCGCGATGG -> CCATAATGTTCGCGATGGC
AGCCGCTATGGTTTCTCAA -> GCCGCTATGGTTTCTCAAA
TAATGACTACGCATGGGAC -> AATGACTACGCATGGGACT
CGGGCGTTCACTAGTCCGC -> GGGCGTTCACTAGTCCGCC
GGCCCGAAGTGAGGAAGTC -> GCCCGAAGTGAGGAAGTCT
TCGGCTGTACCGGTCGCAT -> CGGCTGTACCGGTCGCATT
TAGGTAACCCGGGGCCCGC -> AGGTAACCCGGGGCCCGCT
TCGATCTCCTTTTGACCAA -> CGATCTCCTTTTGACCAAT
ATTATCCATCAGACACACC -> TTATCCATCAGACACACCC
CTTTGCAGCGATCCTTTAC -> TTTGCAGCGATCCTTTACG
TACCGGTCGCATTAATGAC -> ACCGGTCGCATTAATGACT
CCCGGGCCCCTCGATTCCA -> CCGGGCCCCTCGATTCCAG
CACTAATGATGGAACTGTA -> ACTAATGATGGAACTGTAC
TTAAGTTTGGATCAACGTT -> TAAGTTTGGATCAACGTTT
ATGTTAATACCCGGCCGGG -> TGTTAATACCCGGCCGGGA
ACGTTGCACGACTTTATTG -> CGTTGCACGACTTTATTGC
GACAGACCGGGAATGCCGA -> ACAGACCGGGAATGCCGAT
GCCGATCACGGACTGGCTT -> CCGATCACGGACTGGCTTC
CACACGGCACGATGCCTCT -> ACACGGCACGATGCCTCTA
ACCTGCTTCTTATCGCCTT -> CCTGCTTCTTATCGCCTTT
TAGCCCCGGTCACGCGTCT -> AGCCCCGGTCACGCGTCTC
TACGTTGCACGACTTTATT -> ACGTTGCACGACTTTATTG
AACCATTATCCATCAGACA -> ACCATTATCCATCAGACAC
GGATCGGTTACGTTGCACG -> GATCGGTTACGTTGCACGA
TCCGGCAACTCCGATATAC -> CCGGCAACTCCGATATACA
CCGGTCACGCGTCTCTCGT -> CGGTCACGCGTCTCTCGTC
GAATTCAAGAAGGAGGCTC -> AATTCAAGAAGGAGGCTCC
ATCACGGACTGGCTTCCAG -> TCACGGACTGGCTTCCAGG
CGTAACGGGGCCTAATACC -> GTAACGGGGCCTAATACCC
ACCTATGGGTAAAGCGACA -> CCTATGGGTAAAGCGACAA
CTAGCCCCAGGGCCGACTG -> TAGCCCCAGGGCCGACTGA
AAGGGTATGGGGAGGAAGC -> AGGGTATGGGGAGGAAGCC
ATCTTATACAGTAGTCCTT -> TCTTATACAGTAGTCCTTT
ACATCTTTGTTTCACGCGA -> CATCTTTGTTTCACGCGAA
CTTAGGTAACCCGGGGCCC -> TTAGGTAACCCGGGGCCCG
CAGACACTAATGATGGAAC -> AGACACTAATGATGGAACT
CTTCTTATCGCCTTTGGAC -> TTCTTATCGCCTTTGGACG
GTAAATGATTGGTCCCATA -> TAAATGATTGGTCCCATAT
TCTTTGTACTCAATGGATG -> CTTTGTACTCAATGGATGA
AACCGAGCTTCCCTAACTC -> ACCGAGCTTCCCTAACTCC
CTTAGAGGATCGGTTACGT -> TTAGAGGATCGGTTACGTT
ACGGACAAAGTCTGGCTCC -> CGGACAAAGTCTGGCTCCA
GAAACCCTGAACTTGAGGG -> AAACCCTGAACTTGAGGGA
GACACACCCTTGTCGGCTG -> ACACACCCTTGTCGGCTGT
ATGGGCAAAACAGGCTTAC -> TGGGCAAAACAGGCTTACC
CGGAAGTAACTTCGATTTT -> GGAAGTAACTTCGATTTTG
CGGACAAAGTCTGGCTCCA -> GGACAAAGTCTGGCTCCAA
GTTAGCATGTCAGCTCAAC -> TTAGCATGTCAGCTCAACT
TTTGTGGCTCGTAACGGGG -> TTGTGGCTCGTAACGGGGC
AAGAAGGAGGCTCCTGGGG -> AGAAGGAGGCTCCTGGGGC
ACGAGCGGCACCTACCCTC -> CGAGCGGCACCTACCCTCA
TAATGATGGAACTGTACCG -> AATGATGGAACTGTACCGG
CCGTTAGCATGTCAGCTCA -> CGTTAGCATGTCAGCTCAA
AACCTATATGCGAAATCAG -> ACCTATATGCGAAATCAGA
GATCAGGGAAGATCTTTTG -> ATCAGGGAAGATCTTTTGG
CGATACCCATTATCCATCA -> GATACCCATTATCCATCAG
GGGCCTAATACCCCCTACT -> GGCCTAATACCCCCTACTC
TAGAGGGAATGAGACAGAC -> AGAGGGAATGAGACAGACC
TTATGAGTATGTGCGAGGG -> TATGAGTATGTGCGAGGGC
AACTTGAGGGAGTAGAAAA -> ACTTGAGGGAGTAGAAAAA
CACTAGTCCGCCGAATCCG -> ACTAGTCCGCCGAATCCGG
TCTGGGTGACATCTTTGTT -> CTGGGTGACATCTTTGTTT
ACGTTTTCGACAATAAGTC -> CGTTTTCGACAATAAGTCG
GATAGGGCCCGAAGTGAGG -> ATAGGGCCCGAAGTGAGGA
ACAGGCTTACCAAAGAAAG -> CAGGCTTACCAAAGAAAGA
CATCAGACACCCTTGGACG -> ATCAGACACCCTTGGACGT
ATGAGACAGACCGGGAATG -> TGAGACAGACCGGGAATGC
AGGGCCAACTTGCGAGCCG -> GGGCCAACTTGCGAGCCGC
GAGCTTTTGATTTGATCGT -> AGCTTTTGATTTGATCGTG
TACTTCCAGTCAGCTCAGA -> ACTTCCAGTCAGCTCAGAC
TCGCATTAATCCCCACACG -> CGCATTAATCCCCACACGG
TGATGGGCAAAACAGGCTT -> GATGGGCAAAACAGGCTTA
ACCCTGAACTTGAGGGAGT -> CCCTGAACTTGAGGGAGTA
CGGACTGGCTTCCAGGCTT -> GGACTGGCTTCCAGGCTTA
GCGACAACCCCGCCCGTTA -> CGACAACCCCGCCCGTTAG
TCTGCCGACGTTGACCTGT -> CTGCCGACGTTGACCTGTG
GTTTCGGAAGTAACTTCGA -> TTTCGGAAGTAACTTCGAT
GATATAAGTCACTGTACCG -> ATATAAGTCACTGTACCGG
CCGAATCCGGAAGTTTAGG -> CGAATCCGGAAGTTTAGGT
TGTTGCTCTGTAGTAGACC -> GTTGCTCTGTAGTAGACCT
TAGGTAACAGAGTTTATGA -> AGGTAACAGAGTTTATGAG
TCGGGCGTTCACTAGTCCG -> CGGGCGTTCACTAGTCCGC
ATGCCTCTAGCCCCAGGGC -> TGCCTCTAGCCCCAGGGCC
CCGATTGATGCACGGACAA -> CGATTGATGCACGGACAAA
CGAGCCGCTTCTGGGTGAC -> GAGCCGCTTCTGGGTGACA
AGTCCTTTCCGCCGAAAAT -> GTCCTTTCCGCCGAAAATC
ATTATCCATCAGACACTAA -> TTATCCATCAGACACTAAT
ATGGACAGTGGCACACCTG -> TGGACAGTGGCACACCTGC
CCCTCGATTCCAGGTCATG -> CCTCGATTCCAGGTCATGG
TAACTCGACACAGCTCCCT -> AACTCGACACAGCTCCCTT
AGTTTGGATCAACGTTTTA -> GTTTGGATCAACGTTTTAG
TATGCGAAATCAGAATATG -> ATGCGAAATCAGAATATGA
AGCTTCCCTAACTCCCCTA -> GCTTCCCTAACTCCCCTAT
GGCCGGGACACAAACCTGC -> GCCGGGACACAAACCTGCG
CAAACCTGCGTGCTTACTA -> AAACCTGCGTGCTTACTAA
TGACCTGTGGCACTTTGCA -> GACCTGTGGCACTTTGCAG
CAGCTCAACTAAACCATTA -> AGCTCAACTAAACCATTAT
ACAGTAGTCCTTTCCGCCG -> CAGTAGTCCTTTCCGCCGA
GCCGTTTCTGCCGACGTTG -> CCGTTTCTGCCGACGTTGA
AGATATCAAAGTTCAGATT -> GATATCAAAGTTCAGATTG
TCACTGTACCGGTCGCATT -> CACTGTACCGGTCGCATTA
CCGGTCGCATTAATCTGCT -> CGGTCGCATTAATCTGCTC
AGGTAACCCGGGGCCCGCT -> GGTAACCCGGGGCCCGCTT
CCCATATTGCCGTTTCTGC -> CCATATTGCCGTTTCTGCC
AGGTCTTCCATTATCCATC -> GGTCTTCCATTATCCATCA
ATTTCTCCCCTCCGAAAAA -> TTTCTCCCCTCCGAAAAAG
CCATCAGACACACCCTTGT -> CATCAGACACACCCTTGTC
CCTGGGCTCTCCGAAGTGA -> CTGGGCTCTCCGAAGTGAT
CCCTCCGAAAAAGGCGCGA -> CCTCCGAAAAAGGCGCGAC
CTCTTCGTTCATCGGAGAG -> TCTTCGTTCATCGGAGAGG
TCCCCATAGGCACTAGTCT -> CCCCATAGGCACTAGTCTA
TCCAATTAGCCGTCCTATC -> CCAATTAGCCGTCCTATCC
CATAATGTTCGCGATGGCT -> ATAATGTTCGCGATGGCTA
AGGCACATTTCCCGGGCCC -> GGCACATTTCCCGGGCCCC
AGTAGTCCTTTCCGCCGAA -> GTAGTCCTTTCCGCCGAAA
ATTTTGACTGACAATGTTC -> TTTTGACTGACAATGTTCC
CTCAATGGATGACAGTGAT -> TCAATGGATGACAGTGATA
GATCTGATGACCCGTGCGA -> ATCTGATGACCCGTGCGAA
GGCGTCCATAATGTTCGCG -> GCGTCCATAATGTTCGCGA
AGTAGAAAAATACGTTTTC -> GTAGAAAAATACGTTTTCG
AAGTGGCCTTCTACTGGGT -> AGTGGCCTTCTACTGGGTG
TCCGAAACCCTGAACTTGA -> CCGAAACCCTGAACTTGAG
GTAGGCGCGAGTGAAGGCC -> TAGGCGCGAGTGAAGGCCA
TGAACCTATATGCGAAATC -> GAACCTATATGCGAAATCA
GGTTCCGCTCCGTTTAGCC -> GTTCCGCTCCGTTTAGCCC
TGGTTTCTCAAAGGTTAGA -> GGTTTCTCAAAGGTTAGAT
CGTCCGTCTTATAAACCGA -> GTCCGTCTTATAAACCGAG
TAACTCCGAAACCCTGAAC -> AACTCCGAAACCCTGAACT
GGGAGTCAAGTGGCCTTCT -> GGAGTCAAGTGGCCTTCTA
GAGGAAGCCGCTGTAATGG -> AGGAAGCCGCTGTAATGGA
AGACACGATATAAGTCACT -> GACACGATATAAGTCACTG
CGAACCAGCTCGATCTCCT -> GAACCAGCTCGATCTCCTT
TGATGCACGGACAAAGTCT -> GATGCACGGACAAAGTCTG
AATCTGCTCTGATCTTAGA -> ATCTGCTCTGATCTTAGAG
ACCCCGCCCGTTAGCATGT -> CCCCGCCCGTTAGCATGTC
ATAAAAATCCATTCCCTGG -> TAAAAATCCATTCCCTGGG
TATCCATCAGACACACCCT -> ATCCATCAGACACACCCTT
GCTCGTAACGGGGCCTAAT -> CTCGTAACGGGGCCTAATA
ACGCATGGGACTAGTGAAG -> CGCATGGGACTAGTGAAGT
TAACGGGGCCTAATACCCC -> AACGGGGCCTAATACCCCC
AATTTAAGTTTGGATCAAC -> ATTTAAGTTTGGATCAACG
CAAACGCCTCTAAACGGAT -> AAACGCCTCTAAACGGATA
AATTCAAGAAGGAGGCTCC -> ATTCAAGAAGGAGGCTCCT
TTCCCCAGCAAAATTTAAG -> TCCCCAGCAAAATTTAAGT
GAAGTAACTTCGATTTTGA -> AAGTAACTTCGATTTTGAC
GGACGTACTGTACCGGTCG -> GACGTACTGTACCGGTCGC
GTCTAGGGAGCTCCTTTAG -> TCTAGGGAGCTCCTTTAGC
GAGCCGCTTCTGGGTGACA -> AGCCGCTTCTGGGTGACAT
TTACTTTTATGATAGTGGG -> TACTTTTATGATAGTGGGT
GTAGTCCTTTCCGCCGAAA -> TAGTCCTTTCCGCCGAAAA
AGTGCATCCAATTAGCCGT -> GTGCATCCAATTAGCCGTC
TGTTGTTGTTAAAGACTGA -> GTTGTTGTTAAAGACTGAG
GGGGCCAGAGACAGGTGTC -> GGGCCAGAGACAGGTGTCG
TCGATTCCAGGTCATGGAC -> CGATTCCAGGTCATGGACA
CTCCTTTTGACCAATCCCC -> TCCTTTTGACCAATCCCCA
CGGAAAATATAGAGTCTCT -> GGAAAATATAGAGTCTCTT
AAGTCACTGTACCGGTCGC -> AGTCACTGTACCGGTCGCA
TCCTTTCCGCCGAAAATCC -> CCTTTCCGCCGAAAATCCC
TCCCCTATAAAAATCCATT -> CCCCTATAAAAATCCATTC
GGTGTCGCGGCGAGGCACA -> GTGTCGCGGCGAGGCACAT
AATATAGAGTCTCTTCGTT -> ATATAGAGTCTCTTCGTTC
TGTCGGCTGTACCGGTCGC -> GTCGGCTGTACCGGTCGCA
TAGTAGACCTAATGTGCCG -> AGTAGACCTAATGTGCCGC
CTACCTGACAGAATTAGAG -> TACCTGACAGAATTAGAGG
AAGATATCAAAGTTCAGAT -> AGATATCAAAGTTCAGATT
TCGTGGTTGAGGGGTTAGA -> CGTGGTTGAGGGGTTAGAA
ACTACGCATGGGACTAGTG -> CTACGCATGGGACTAGTGA
ACAGAATTAGAGGGAATGA -> CAGAATTAGAGGGAATGAG
GCTCCGTTTAGCCCCGGTC -> CTCCGTTTAGCCCCGGTCA
GACAGTGGCACACCTGCTT -> ACAGTGGCACACCTGCTTC
TGAACTTGAGGGAGTAGAA -> GAACTTGAGGGAGTAGAAA
TCCATCAGACACCCTTGGA -> CCATCAGACACCCTTGGAC
TTGCGCCAAGCGGCTTCAG -> TGCGCCAAGCGGCTTCAGC
TGAGGCGATACCCATTATC -> GAGGCGATACCCATTATCC
CGGATAGGGCCCGAAGTGA -> GGATAGGGCCCGAAGTGAG
TGCAGCGATCCTTTACGAG -> GCAGCGATCCTTTACGAGC
GTTTGGATCAACGTTTTAG -> TTTGGATCAACGTTTTAGG
CGGAGTAAATGATTGGTCC -> GGAGTAAATGATTGGTCCC
TTTTGACTGACAATGTTCC -> TTTGACTGACAATGTTCCC
GTATGTGCGAGGGCCAACT -> TATGTGCGAGGGCCAACTT
CCCAGGGCCGACTGAGGAT -> CCAGGGCCGACTGAGGATA
AAGCGCACTTCTTCGTAAC -> AGCGCACTTCTTCGTAACT
AGTGAGGAAGTCTAGATAT -> GTGAGGAAGTCTAGATATG
GCAAAACAGGCTTACCAAA -> CAAAACAGGCTTACCAAAG
CCGGAAGTTTAGGTAACAG -> CGGAAGTTTAGGTAACAGA
AGCTCAACTAAACCATTAT -> GCTCAACTAAACCATTATC
GCCCATGTACGATCTACTT -> CCCATGTACGATCTACTTC
ATGGGACTAGTGAAGTTGA -> TGGGACTAGTGAAGTTGAC
AGTTTAGGTAACAGAGTTT -> GTTTAGGTAACAGAGTTTA
GACAACCCCGCCCGTTAGC -> ACAACCCCGCCCGTTAGCA
GCCAAGCGGCTTCAGCGCG -> CCAAGCGGCTTCAGCGCGT
ACGATGCCTCTAGCCCCAG -> CGATGCCTCTAGCCCCAGG
AAAGCGACAACCCCGCCCG -> AAGCGACAACCCCGCCCGT
GTCGGGCGTTCACTAGTCC -> TCGGGCGTTCACTAGTCCG
TGCGTGCTTACTAACTCCG -> GCGTGCTTACTAACTCCGA
TCACGCGAAGATTTCTCCC -> CACGCGAAGATTTCTCCCC
CCCCATAGGCACTAGTCTA -> CCCATAGGCACTAGTCTAC
CTGGACGATAACAGCCCAG -> TGGACGATAACAGCCCAGC
TTACTAACTCCGAAACCCT -> TACTAACTCCGAAACCCTG
GCGTGCTTACTAACTCCGA -> CGTGCTTACTAACTCCGAA
GGACCGCCCATGTACGATC -> GACCGCCCATGTACGATCT
GGCCCGCTTCCCAGTATAC -> GCCCGCTTCCCAGTATACA
TAGCTCTGTTGTTGTTAAA -> AGCTCTGTTGTTGTTAAAG
TATTGATCCATAGGGCGTC -> ATTGATCCATAGGGCGTCC
CATCGGAGAGGCTCCCATT -> ATCGGAGAGGCTCCCATTG
GCTTACTAACTCCGAAACC -> CTTACTAACTCCGAAACCC
GACTTGTTGATCGGACCTA -> ACTTGTTGATCGGACCTAT
GTCATCCTTCGGGTCGAAC -> TCATCCTTCGGGTCGAACC
TTTGAAACGTCCGTCTTAT -> TTGAAACGTCCGTCTTATA
TTAAGATCCTTTACATAAG -> TAAGATCCTTTACATAAGG
TTCCCTAACTCCCCTATAA -> TCCCTAACTCCCCTATAAA
GATACCCATTATCCATCAG -> ATACCCATTATCCATCAGA
CCCCCTACTCTGGACGATA -> CCCCTACTCTGGACGATAA
AACCAGCTCGATCTCCTTT -> ACCAGCTCGATCTCCTTTT
CATTGATTGGTAGAAACAA -> ATTGATTGGTAGAAACAAC
GGCTTAGGTAACCCGGGGC -> GCTTAGGTAACCCGGGGCC
GGGAGGAAGCCGCTGTAAT -> GGAGGAAGCCGCTGTAATG
CACGATATAAGTCACTGTA -> ACGATATAAGTCACTGTAC
CGCATTAATGTTGCTCTGT -> GCATTAATGTTGCTCTGTA
TAAAGCAAGCCGCTATGGT -> AAAGCAAGCCGCTATGGTT
TTGTGGCTCGTAACGGGGC -> TGTGGCTCGTAACGGGGCC
GGCTCTCCGAAGTGATGGG -> GCTCTCCGAAGTGATGGGC
GTAACAGAGTTTATGAGTA -> TAACAGAGTTTATGAGTAT
TGGGTGACATCTTTGTTTC -> GGGTGACATCTTTGTTTCA
CCCAGCGCGTAATTTACGG -> CCAGCGCGTAATTTACGGC
GGCTACCTGACAGAATTAG -> GCTACCTGACAGAATTAGA
TACTTTTATGATAGTGGGT -> ACTTTTATGATAGTGGGTC
CGGCCGTCAACGGGACCGC -> GGCCGTCAACGGGACCGCC
CCCAGCAAAATTTAAGTTT -> CCAGCAAAATTTAAGTTTG
CGAAGACTTGTTGATCGGA -> GAAGACTTGTTGATCGGAC
AGCTCTGTTGTTGTTAAAG -> GCTCTGTTGTTGTTAAAGA
CCCCAGCAAAATTTAAGTT -> CCCAGCAAAATTTAAGTTT
AGAGACAGGTGTCGCGGCG -> GAGACAGGTGTCGCGGCGA
ATGGCTACCTGACAGAATT -> TGGCTACCTGACAGAATTA
AAGGCGCGACCTATGTTTA -> AGGCGCGACCTATGTTTAA
ACGTTCATGCTTGACCGTT -> CGTTCATGCTTGACCGTTA
TACGCATGGGACTAGTGAA -> ACGCATGGGACTAGTGAAG
GCTTTCTTGATGCCATTAT -> CTTTCTTGATGCCATTATC
ATCGCCTTTGGACGGTTAC -> TCGCCTTTGGACGGTTACT
GACCTATGGGTAAAGCGAC -> ACCTATGGGTAAAGCGACA
AGCGACAACCCCGCCCGTT -> GCGACAACCCCGCCCGTTA
TGCTTACTAACTCCGAAAC -> GCTTACTAACTCCGAAACC
AAGTCAAATCTCCTCAACA -> AGTCAAATCTCCTCAACAT
GCCTTTGGACGGTTACTTT -> CCTTTGGACGGTTACTTTT
CGCCCATGTACGATCTACT -> GCCCATGTACGATCTACTT
CATTATCCATCAGACACTA -> ATTATCCATCAGACACTAA
AAATCCATTCCCTGGGCTC -> AATCCATTCCCTGGGCTCT
ACGTACTGTACCGGTCGCA -> CGTACTGTACCGGTCGCAT
CAGCGCGTCGAGCTTTTGA -> AGCGCGTCGAGCTTTTGAT
GTGATACGCAAACGCCTCT -> TGATACGCAAACGCCTCTA
CAAGTCAAATCTCCTCAAC -> AAGTCAAATCTCCTCAACA
AATTAGAGGGAATGAGACA -> ATTAGAGGGAATGAGACAG
CGAAATCAGAATATGAAAT -> GAAATCAGAATATGAAATC
TTTCCGCCGAAAATCCCTT -> TTCCGCCGAAAATCCCTTT
TTAACGGACCCGGAAAATA -> TAACGGACCCGGAAAATAT
CCTCAGTACCCTAACTGCG -> CTCAGTACCCTAACTGCGG
AACGTCCGTCTTATAAACC -> ACGTCCGTCTTATAAACCG
GTTTAACGGACCCGGAAAA -> TTTAACGGACCCGGAAAAT
AAATACGTTTTCGACAATA -> AATACGTTTTCGACAATAA
TTTCTTGATGCCATTATCC -> TTCTTGATGCCATTATCCA
CTACCCTCAGTACCCTAAC -> TACCCTCAGTACCCTAACT
GCGTCTCTCGTCGAGAGGC -> CGTCTCTCGTCGAGAGGCG
GCTCTCCGAAGTGATGGGC -> CTCTCCGAAGTGATGGGCA
CCATTCCCTGGGCTCTCCG -> CATTCCCTGGGCTCTCCGA
TATACATGTTAATACCCGG -> ATACATGTTAATACCCGGC
CCAGTATACATGTTAATAC -> CAGTATACATGTTAATACC
GCCAGAGACAGGTGTCGCG -> CCAGAGACAGGTGTCGCGG
TCTCCGAAGTGATGGGCAA -> CTCCGAAGTGATGGGCAAA
CGGTTACTTTTATGATAGT -> GGTTACTTTTATGATAGTG
TCCCCTCCGAAAAAGGCGC -> CCCCTCCGAAAAAGGCGCG
AGCCCCGGTCACGCGTCTC -> GCCCCGGTCACGCGTCTCT
CTAAACGGATAGGGCCCGA -> TAAACGGATAGGGCCCGAA
CTCCCATTGATTGGTAGAA -> TCCCATTGATTGGTAGAAA
TTGATCGTGGTTGAGGGGT -> TGATCGTGGTTGAGGGGTT
GAAAAATACGTTTTCGACA -> AAAAATACGTTTTCGACAA
GCGTCGAGCTTTTGATTTG -> CGTCGAGCTTTTGATTTGA
AAACAACTGCCGATGAACC -> AACAACTGCCGATGAACCT
TGCGAAATCAGAATATGAA -> GCGAAATCAGAATATGAAA
GGGCCAGAGACAGGTGTCG -> GGCCAGAGACAGGTGTCGC
GTTGTTAAAGACTGAGGCG -> TTGTTAAAGACTGAGGCGA
TAGTCTACACAGGTCTTCC -> AGTCTACACAGGTCTTCCA
AAAGCGCACTTCTTCGTAA -> AAGCGCACTTCTTCGTAAC
ATGCTATCTTATACAGTAG -> TGCTATCTTATACAGTAGT
AGCTCGATCTCCTTTTGAC -> GCTCGATCTCCTTTTGACC
TCGTAACTCGACACAGCTC -> CGTAACTCGACACAGCTCC
GGCAGACAGTGCATCCAAT -> GCAGACAGTGCATCCAATT
TATACAGTAGTCCTTTCCG -> ATACAGTAGTCCTTTCCGC
ATCAGACACACCCTTGTCG -> TCAGACACACCCTTGTCGG
AGGCGACTGTCTACATCGG -> GGCGACTGTCTACATCGGC
GGCGAGGCACATTTCCCGG -> GCGAGGCACATTTCCCGGG
TTGGTCCCATATTGCCGTT -> TGGTCCCATATTGCCGTTT
CGACCTATGTTTAACGGAC -> GACCTATGTTTAACGGACC
CGAAAAAGGCGCGACCTAT -> GAAAAAGGCGCGACCTATG
GAAGGCCACGTAAAGCAAG -> AAGGCCACGTAAAGCAAGC
GCTACCTGACAGAATTAGA -> CTACCTGACAGAATTAGAG
GTGCCGCTTTCTTGATGCC -> TGCCGCTTTCTTGATGCCA
GGACCCGGAAAATATAGAG -> GACCCGGAAAATATAGAGT
CAATGGATGACAGTGATAC -> AATGGATGACAGTGATACG
AAAAATCCATTCCCTGGGC -> AAAATCCATTCCCTGGGCT
TTGATGCACGGACAAAGTC -> TGATGCACGGACAAAGTCT
TTTTATGATAGTGGGTCTA -> TTTATGATAGTGGGTCTAG
AAAGAAAGATATCAAAGTT -> AAGAAAGATATCAAAGTTC
TCATGGACAGTGGCACACC -> CATGGACAGTGGCACACCT
CCGGCCGTCAACGGGACCG -> CGGCCGTCAACGGGACCGC
TCACGCGTCTCTCGTCGAG -> CACGCGTCTCTCGTCGAGA
TATCCGGCAACTCCGATAT -> ATCCGGCAACTCCGATATA
TATCCATCAGACACTAATG -> ATCCATCAGACACTAATGA
CCATAGGCACTAGTCTACA -> CATAGGCACTAGTCTACAC
ATGATAGTGGGTCTAGGGA -> TGATAGTGGGTCTAGGGAG
TGCTTCTTATCGCCTTTGG -> GCTTCTTATCGCCTTTGGA
GCCCGCTTCCCAGTATACA -> CCCGCTTCCCAGTATACAT
AAAATCCCTTTGTGGCTCG -> AAATCCCTTTGTGGCTCGT
CATTAATGACTACGCATGG -> ATTAATGACTACGCATGGG
GAATATGAAATCGAAGCGG -> AATATGAAATCGAAGCGGT
ATTTCCCGGGCCCCTCGAT -> TTTCCCGGGCCCCTCGATT
AAGTAACTTCGATTTTGAC -> AGTAACTTCGATTTTGACT
GACAGTGCATCCAATTAGC -> ACAGTGCATCCAATTAGCC
AATGATTGGTCCCATATTG -> ATGATTGGTCCCATATTGC
GTCGCATTAATGTTGCTCT -> TCGCATTAATGTTGCTCTG
TCTTAGAGGATCGGTTACG -> CTTAGAGGATCGGTTACGT
TCCATCAGACACTAATGAT -> CCATCAGACACTAATGATG
CTTCGATTTTGACTGACAA -> TTCGATTTTGACTGACAAT
GGTTAGAATGACGTGACGA -> GTTAGAATGACGTGACGAT
CCATTATCCATCAGACACA -> CATTATCCATCAGACACAC
CCTTCTACTGGGTGTAGGC -> CTTCTACTGGGTGTAGGCG
ACCGGTCGCATTAATGACT -> CCGGTCGCATTAATGACTA
CTTCCAGTCAGCTCAGACG -> TTCCAGTCAGCTCAGACGC
GGCTTCAGCGCGTCGAGCT -> GCTTCAGCGCGTCGAGCTT
TTTCCCGGGCCCCTCGATT -> TTCCCGGGCCCCTCGATTC
GGTGTAGGCGCGAGTGAAG -> GTGTAGGCGCGAGTGAAGG
TATAAAAATCCATTCCCTG -> ATAAAAATCCATTCCCTGG
CCCATAGGCACTAGTCTAC -> CCATAGGCACTAGTCTACA
AACGGACCCGGAAAATATA -> ACGGACCCGGAAAATATAG
AGACAGTGCATCCAATTAG -> GACAGTGCATCCAATTAGC
CCGAAGTGATGGGCAAAAC -> CGAAGTGATGGGCAAAACA
CGCGTCGAGCTTTTGATTT -> GCGTCGAGCTTTTGATTTG
TGCGAAAGCGCACTTCTTC -> GCGAAAGCGCACTTCTTCG
CAGGTCATGGACAGTGGCA -> AGGTCATGGACAGTGGCAC
GACACCCTTGGACGTACTG -> ACACCCTTGGACGTACTGT
TCCGATGAATAGTTAAGAT -> CCGATGAATAGTTAAGATC
AAGTCGATCCGATTGATGC -> AGTCGATCCGATTGATGCA
AAAAATACGTTTTCGACAA -> AAAATACGTTTTCGACAAT
ACCGGTCGCATTAATGTTG -> CCGGTCGCATTAATGTTGC
CTTCGGGTCGAACCAGCTC -> TTCGGGTCGAACCAGCTCG
GGGAATGAGACAGACCGGG -> GGAATGAGACAGACCGGGA
ACTAATGATGGAACTGTAC -> CTAATGATGGAACTGTACC
TATAGAGTCTCTTCGTTCA -> ATAGAGTCTCTTCGTTCAT
GATTGGACGATCTGATGAC -> ATTGGACGATCTGATGACC
GATGGAACTGTACCGGTCG -> ATGGAACTGTACCGGTCGC
TAACAGAGTTTATGAGTAT -> AACAGAGTTTATGAGTATG
AAGTCTGGCTCCAAGTCAA -> AGTCTGGCTCCAAGTCAAA
CACCCTTGTCGGCTGTACC -> ACCCTTGTCGGCTGTACCG
CCTTTGGACGGTTACTTTT -> CTTTGGACGGTTACTTTTA
TTACCAAAGAAAGATATCA -> TACCAAAGAAAGATATCAA
ATAACCGGCCGTCAACGGG -> TAACCGGCCGTCAACGGGA
ACGCGTCTCTCGTCGAGAG -> CGCGTCTCTCGTCGAGAGG
GACAGTGATACGCAAACGC -> ACAGTGATACGCAAACGCC
GGGAATGCCGATCACGGAC -> GGAATGCCGATCACGGACT
TGGTCCCATATTGCCGTTT -> GGTCCCATATTGCCGTTTC
AAAAAGGCGCGACCTATGT -> AAAAGGCGCGACCTATGTT
TGCCGTTTCTGCCGACGTT -> GCCGTTTCTGCCGACGTTG
TGCACGGACAAAGTCTGGC -> GCACGGACAAAGTCTGGCT
CTGATCTTAGAGGATCGGT -> TGATCTTAGAGGATCGGTT
TCCATCAGACACACCCTTG -> CCATCAGACACACCCTTGT
ACGGCACGATGCCTCTAGC -> CGGCACGATGCCTCTAGCC
GACGGTTACTTTTATGATA -> ACGGTTACTTTTATGATAG
ATGCCGATCACGGACTGGC -> TGCCGATCACGGACTGGCT
CTTGACGTTCATGCTTGAC -> TTGACGTTCATGCTTGACC
ATGTGCGAGGGCCAACTTG -> TGTGCGAGGGCCAACTTGC
AGACACACCCTTGTCGGCT -> GACACACCCTTGTCGGCTG
ACGATATAAGTCACTGTAC -> CGATATAAGTCACTGTACC
TAACGGACCCGGAAAATAT -> AACGGACCCGGAAAATATA
TAGTCCTTTCCGCCGAAAA -> AGTCCTTTCCGCCGAAAAT
GAAAATCCCTTTGTGGCTC -> AAAATCCCTTTGTGGCTCG
GTCGAACCAGCTCGATCTC -> TCGAACCAGCTCGATCTCC
ACGGGACCGCCCATGTACG -> CGGGACCGCCCATGTACGA
CGTGACGATCAGGGAAGAT -> GTGACGATCAGGGAAGATC
TGACCCGTGCGAAAGCGCA -> GACCCGTGCGAAAGCGCAC
GCCGACTGAGGATAAATGC -> CCGACTGAGGATAAATGCT
GACAAAGTCTGGCTCCAAG -> ACAAAGTCTGGCTCCAAGT
AAAATCCATTCCCTGGGCT -> AAATCCATTCCCTGGGCTC
AGTCTCTTCGTTCATCGGA -> GTCTCTTCGTTCATCGGAG
GTGAAGGCCACGTAAAGCA -> TGAAGGCCACGTAAAGCAA
GTCTCTCGTCGAGAGGCGA -> TCTCTCGTCGAGAGGCGAC
TTTGATTTGATCGTGGTTG -> TTGATTTGATCGTGGTTGA
AAAACAGGCTTACCAAAGA -> AAACAGGCTTACCAAAGAA
AGAGTTTATGAGTATGTGC -> GAGTTTATGAGTATGTGCG
CTGAACTTGAGGGAGTAGA -> TGAACTTGAGGGAGTAGAA
GCTTTTGATTTGATCGTGG -> CTTTTGATTTGATCGTGGT
ATAGAGTCTCTTCGTTCAT -> TAGAGTCTCTTCGTTCATC
TAATGTTGCTCTGTAGTAG -> AATGTTGCTCTGTAGTAGA
GGTATGGGGAGGAAGCCGC -> GTATGGGGAGGAAGCCGCT
AAGCGACAACCCCGCCCGT -> AGCGACAACCCCGCCCGTT
TGTGCGAGGGCCAACTTGC -> GTGCGAGGGCCAACTTGCG
CCCGAAGTGAGGAAGTCTA -> CCGAAGTGAGGAAGTCTAG
CCCTAACTGCGGGTCGGGC -> CCTAACTGCGGGTCGGGCG
TTCAAGAAGGAGGCTCCTG -> TCAAGAAGGAGGCTCCTGG
TCCGATATACAAAGAGATC -> CCGATATACAAAGAGATCC
AAATCTCCTCAACATAACC -> AATCTCCTCAACATAACCG
ACCCGGCCGGGACACAAAC -> CCCGGCCGGGACACAAACC
ATTGCCGTTTCTGCCGACG -> TTGCCGTTTCTGCCGACGT
TGGACGGTTACTTTTATGA -> GGACGGTTACTTTTATGAT
ATAATGTTCGCGATGGCTA -> TAATGTTCGCGATGGCTAC
ATTGTTTCGGAAGTAACTT -> TTGTTTCGGAAGTAACTTC
AAATCCCTTTGTGGCTCGT -> AATCCCTTTGTGGCTCGTA
CCTGGGGCCAGAGACAGGT -> CTGGGGCCAGAGACAGGTG
CAAGTGGCCTTCTACTGGG -> AAGTGGCCTTCTACTGGGT
CCGGGACACAAACCTGCGT -> CGGGACACAAACCTGCGTG
GCTTCCCTAACTCCCCTAT -> CTTCCCTAACTCCCCTATA
GAACTGTACCGGTCGCATT -> AACTGTACCGGTCGCATTA
TTTACGAGCGGCACCTACC -> TTACGAGCGGCACCTACCC
GTGCGAAAGCGCACTTCTT -> TGCGAAAGCGCACTTCTTC
CGAAGTGAGGAAGTCTAGA -> GAAGTGAGGAAGTCTAGAT
AATGACTACGCATGGGACT -> ATGACTACGCATGGGACTA
GTACCCTAACTGCGGGTCG -> TACCCTAACTGCGGGTCGG
ACACCCTTGTCGGCTGTAC -> CACCCTTGTCGGCTGTACC
TGATGCCATTATCCATCAG -> GATGCCATTATCCATCAGA
CGTCGAGCTTTTGATTTGA -> GTCGAGCTTTTGATTTGAT
CTCGTAACGGGGCCTAATA -> TCGTAACGGGGCCTAATAC
TAACTCCCCTATAAAAATC -> AACTCCCCTATAAAAATCC
AATGACGTGACGATCAGGG -> ATGACGTGACGATCAGGGA
