GCGAAGGACGT -> CGAAGGACGTA
CGAAGGACGTA -> GAAGGACGTAA
GAAGGACGTAA -> AAGGACGTAAC
AAGGACGTAAC -> AGGACGTAACG
AGGACGTAACG -> GGACGTAACGA
GGACGTAACGA -> GACGTAACGAA
GACGTAACGAA -> ACGTAACGAAA
ACGTAACGAAA -> CGTAACGAAAC
CGTAACGAAAC -> GTAACGAAACG
GTAACGAAACG -> TAACGAAACGT
TAACGAAACGT -> AACGAAACGTA
AACGAAACGTA -> ACGAAACGTAG
ACGAAACGTAG -> CGAAACGTAGT
CGAAACGTAGT -> GAAACGTAGTA
GAAACGTAGTA -> AAACGTAGTAG
AAACGTAGTAG -> AACGTAGTAGA
AACGTAGTAGA -> ACGTAGTAGAT
ACGTAGTAGAT -> CGTAGTAGATA
CGTAGTAGATA -> GTAGTAGATAC
GTAGTAGATAC -> TAGTAGATACA
TAGTAGATACA -> AGTAGATACAT
AGTAGATACAT -> GTAGATACATA
GTAGATACATA -> TAGATACATAC
TAGATACATAC -> AGATACATACT
AGATACATACT -> GATACATACTA
GATACATACTA -> ATACATACTAC
ATACATACTAC -> TACATACTACA
TACATACTACA -> ACATACTACAT
ACATACTACAT -> CATACTACATA
CATACTACATA -> ATACTACATAG
ATACTACATAG -> TACTACATAGG
TACTACATAGG -> ACTACATAGGC
ACTACATAGGC -> CTACATAGGCA
CTACATAGGCA -> TACATAGGCAA
TACATAGGCAA -> ACATAGGCAAC
ACATAGGCAAC -> CATAGGCAACT
CATAGGCAACT -> ATAGGCAACTA
ATAGGCAACTA -> TAGGCAACTAC
TAGGCAACTAC -> AGGCAACTACA
AGGCAACTACA -> GGCAACTACAC
GGCAACTACAC -> GCAACTACACT
GCAACTACACT -> CAACTACACTT
CAACTACACTT -> AACTACACTTG
AACTACACTTG -> ACTACACTTGC
ACTACACTTGC -> CTACACTTGCC
CTACACTTGCC -> TACACTTGCCT
TACACTTGCCT -> ACACTTGCCTA
ACACTTGCCTA -> CACTTGCCTAC
CACTTGCCTAC -> ACTTGCCTACT
ACTTGCCTACT -> CTTGCCTACTC
CTTGCCTACTC -> TTGCCTACTCG
TTGCCTACTCG -> TGCCTACTCGG
TGCCTACTCGG -> GCCTACTCGGC
GCCTACTCGGC -> CCTACTCGGCG
CCTACTCGGCG -> CTACTCGGCGC
CTACTCGGCGC -> TACTCGGCGCG
TACTCGGCGCG -> ACTCGGCGCGC
ACTCGGCGCGC -> CTCGGCGCGCA
CTCGGCGCGCA -> TCGGCGCGCAG
TCGGCGCGCAG -> CGGCGCGCAGA
CGGCGCGCAGA -> GGCGCGCAGAA
GGCGCGCAGAA -> GCGCGCAGAAC
GCGCGCAGAAC -> CGCGCAGAACC
CGCGCAGAACC -> GCGCAGAACCA
GCGCAGAACCA -> CGCAGAACCAC
CGCAGAACCAC -> GCAGAACCACT
GCAGAACCACT -> CAGAACCACTA
CAGAACCACTA -> AGAACCACTAT
AGAACCACTAT -> GAACCACTATT
GAACCACTATT -> AACCACTATTT
AACCACTATTT -> ACCACTATTTT
ACCACTATTTT -> CCACTATTTTA
CCACTATTTTA -> CACTATTTTAA
CACTATTTTAA -> ACTATTTTAAC
ACTATTTTAAC -> CTATTTTAACG
CTATTTTAACG -> TATTTTAACGG
TATTTTAACGG -> ATTTTAACGGG
ATTTTAACGGG -> TTTTAACGGGG
TTTTAACGGGG -> TTTAACGGGGC
TTTAACGGGGC -> TTAACGGGGCA
TTAACGGGGCA -> TAACGGGGCAG
TAACGGGGCAG -> AACGGGGCAGG
AACGGGGCAGG -> ACGGGGCAGGG
ACGGGGCAGGG -> CGGGGCAGGGG
CGGGGCAGGGG -> GGGGCAGGGGT
GGGGCAGGGGT -> GGGCAGGGGTG
GGGCAGGGGTG -> GGCAGGGGTGC
GGCAGGGGTGC -> GCAGGGGTGCC
GCAGGGGTGCC -> CAGGGGTGCCT
CAGGGGTGCCT -> AGGGGTGCCTC
AGGGGTGCCTC -> GGGGTGCCTCG
GGGGTGCCTCG -> GGGTGCCTCGG
GGGTGCCTCGG -> GGTGCCTCGGT
GGTGCCTCGGT -> GTGCCTCGGTT
GTGCCTCGGTT -> TGCCTCGGTTG
TGCCTCGGTTG -> GCCTCGGTTGA
GCCTCGGTTGA -> CCTCGGTTGAT
CCTCGGTTGAT -> CTCGGTTGATC
CTCGGTTGATC -> TCGGTTGATCA
TCGGTTGATCA -> CGGTTGATCAT
CGGTTGATCAT -> GGTTGATCATG
GGTTGATCATG -> GTTGATCATGA
GTTGATCATGA -> TTGATCATGAT
TTGATCATGAT -> TGATCATGATT
TGATCATGATT -> GATCATGATTT
GATCATGATTT -> ATCATGATTTC
ATCATGATTTC -> TCATGATTTCG
TCATGATTTCG -> CATGATTTCGG
CATGATTTCGG -> ATGATTTCGGC
ATGATTTCGGC -> TGATTTCGGCT
TGATTTCGGCT -> GATTTCGGCTG
GATTTCGGCTG -> ATTTCGGCTGG
ATTTCGGCTGG -> TTTCGGCTGGA
TTTCGGCTGGA -> TTCGGCTGGAT
TTCGGCTGGAT -> TCGGCTGGATA
TCGGCTGGATA -> CGGCTGGATAT
CGGCTGGATAT -> GGCTGGATATC
GGCTGGATATC -> GCTGGATATCG
GCTGGATATCG -> CTGGATATCGG
CTGGATATCGG -> TGGATATCGGC
TGGATATCGGC -> GGATATCGGCA
GGATATCGGCA -> GATATCGGCAG
GATATCGGCAG -> ATATCGGCAGT
ATATCGGCAGT -> TATCGGCAGTC
TATCGGCAGTC -> ATCGGCAGTCA
ATCGGCAGTCA -> TCGGCAGTCAT
TCGGCAGTCAT -> CGGCAGTCATT
CGGCAGTCATT -> GGCAGTCATTA
GGCAGTCATTA -> GCAGTCATTAT
GCAGTCATTAT -> CAGTCATTATA
CAGTCATTATA -> AGTCATTATAA
AGTCATTATAA -> GTCATTATAAC
GTCATTATAAC -> TCATTATAACG
TCATTATAACG -> CATTATAACGT
CATTATAACGT -> ATTATAACGTA
ATTATAACGTA -> TTATAACGTAC
TTATAACGTAC -> TATAACGTACT
TATAACGTACT -> ATAACGTACTC
ATAACGTACTC -> TAACGTACTCC
TAACGTACTCC -> AACGTACTCCT
AACGTACTCCT -> ACGTACTCCTA
ACGTACTCCTA -> CGTACTCCTAT
CGTACTCCTAT -> GTACTCCTATG
GTACTCCTATG -> TACTCCTATGC
TACTCCTATGC -> ACTCCTATGCT
ACTCCTATGCT -> CTCCTATGCTT
CTCCTATGCTT -> TCCTATGCTTG
TCCTATGCTTG -> CCTATGCTTGG
CCTATGCTTGG -> CTATGCTTGGG
CTATGCTTGGG -> TATGCTTGGGC
TATGCTTGGGC -> ATGCTTGGGCT
ATGCTTGGGCT -> TGCTTGGGCTT
TGCTTGGGCTT -> GCTTGGGCTTT
GCTTGGGCTTT -> CTTGGGCTTTG
CTTGGGCTTTG -> TTGGGCTTTGA
TTGGGCTTTGA -> TGGGCTTTGAG
TGGGCTTTGAG -> GGGCTTTGAGA
GGGCTTTGAGA -> GGCTTTGAGAT
GGCTTTGAGAT -> GCTTTGAGATC
GCTTTGAGATC -> CTTTGAGATCT
CTTTGAGATCT -> TTTGAGATCTT
TTTGAGATCTT -> TTGAGATCTTA
TTGAGATCTTA -> TGAGATCTTAC
TGAGATCTTAC -> GAGATCTTACA
GAGATCTTACA -> AGATCTTACAA
AGATCTTACAA -> GATCTTACAAC
GATCTTACAAC -> ATCTTACAACA
ATCTTACAACA -> TCTTACAACAC
TCTTACAACAC -> CTTACAACACC
CTTACAACACC -> TTACAACACCT
TTACAACACCT -> TACAACACCTG
TACAACACCTG -> ACAACACCTGC
ACAACACCTGC -> CAACACCTGCT
CAACACCTGCT -> AACACCTGCTG
AACACCTGCTG -> ACACCTGCTGC
ACACCTGCTGC -> CACCTGCTGCA
CACCTGCTGCA -> ACCTGCTGCAG
ACCTGCTGCAG -> CCTGCTGCAGA
CCTGCTGCAGA -> CTGCTGCAGAA
CTGCTGCAGAA -> TGCTGCAGAAT
TGCTGCAGAAT -> GCTGCAGAATC
GCTGCAGAATC -> CTGCAGAATCA
CTGCAGAATCA -> TGCAGAATCAT
TGCAGAATCAT -> GCAGAATCATA
GCAGAATCATA -> CAGAATCATAC
CAGAATCATAC -> AGAATCATACT
AGAATCATACT -> GAATCATACTT
GAATCATACTT -> AATCATACTTA
AATCATACTTA -> ATCATACTTAA
ATCATACTTAA -> TCATACTTAAC
TCATACTTAAC -> CATACTTAACA
CATACTTAACA -> ATACTTAACAA
ATACTTAACAA -> TACTTAACAAT
TACTTAACAAT -> ACTTAACAATA
ACTTAACAATA -> CTTAACAATAG
CTTAACAATAG -> TTAACAATAGG
TTAACAATAGG -> TAACAATAGGT
TAACAATAGGT -> AACAATAGGTC
AACAATAGGTC -> ACAATAGGTCT
ACAATAGGTCT -> CAATAGGTCTG
CAATAGGTCTG -> AATAGGTCTGC
AATAGGTCTGC -> ATAGGTCTGCC
ATAGGTCTGCC -> TAGGTCTGCCC
TAGGTCTGCCC -> AGGTCTGCCCG
AGGTCTGCCCG -> GGTCTGCCCGG
GGTCTGCCCGG -> GTCTGCCCGGC
GTCTGCCCGGC -> TCTGCCCGGCA
TCTGCCCGGCA -> CTGCCCGGCAT
CTGCCCGGCAT -> TGCCCGGCATG
TGCCCGGCATG -> GCCCGGCATGT
GCCCGGCATGT -> CCCGGCATGTT
CCCGGCATGTT -> CCGGCATGTTG
CCGGCATGTTG -> CGGCATGTTGC
CGGCATGTTGC -> GGCATGTTGCC
GGCATGTTGCC -> GCATGTTGCCT
GCATGTTGCCT -> CATGTTGCCTC
CATGTTGCCTC -> ATGTTGCCTCG
ATGTTGCCTCG -> TGTTGCCTCGT
TGTTGCCTCGT -> GTTGCCTCGTC
GTTGCCTCGTC -> TTGCCTCGTCA
TTGCCTCGTCA -> TGCCTCGTCAC
TGCCTCGTCAC -> GCCTCGTCACA
GCCTCGTCACA -> CCTCGTCACAG
CCTCGTCACAG -> CTCGTCACAGC
CTCGTCACAGC -> TCGTCACAGCG
TCGTCACAGCG -> CGTCACAGCGT
CGTCACAGCGT -> GTCACAGCGTG
GTCACAGCGTG -> TCACAGCGTGT
TCACAGCGTGT -> CACAGCGTGTT
CACAGCGTGTT -> ACAGCGTGTTC
ACAGCGTGTTC -> CAGCGTGTTCT
CAGCGTGTTCT -> AGCGTGTTCTG
AGCGTGTTCTG -> GCGTGTTCTGC
GCGTGTTCTGC -> CGTGTTCTGCC
CGTGTTCTGCC -> GTGTTCTGCCA
GTGTTCTGCCA -> TGTTCTGCCAT
TGTTCTGCCAT -> GTTCTGCCATC
GTTCTGCCATC -> TTCTGCCATCT
TTCTGCCATCT -> TCTGCCATCTG
TCTGCCATCTG -> CTGCCATCTGA
CTGCCATCTGA -> TGCCATCTGAA
TGCCATCTGAA -> GCCATCTGAAG
GCCATCTGAAG -> CCATCTGAAGA
CCATCTGAAGA -> CATCTGAAGAA
CATCTGAAGAA -> ATCTGAAGAAA
ATCTGAAGAAA -> TCTGAAGAAAA
TCTGAAGAAAA -> CTGAAGAAAAT
CTGAAGAAAAT -> TGAAGAAAATC
TGAAGAAAATC -> GAAGAAAATCG
GAAGAAAATCG -> AAGAAAATCGC
AAGAAAATCGC -> AGAAAATCGCG
AGAAAATCGCG -> GAAAATCGCGG
GAAAATCGCGG -> AAAATCGCGGG
AAAATCGCGGG -> AAATCGCGGGT
AAATCGCGGGT -> AATCGCGGGTC
AATCGCGGGTC -> ATCGCGGGTCC
ATCGCGGGTCC -> TCGCGGGTCCA
TCGCGGGTCCA -> CGCGGGTCCAT
CGCGGGTCCAT -> GCGGGTCCATT
GCGGGTCCATT -> CGGGTCCATTG
CGGGTCCATTG -> GGGTCCATTGC
GGGTCCATTGC -> GGTCCATTGCA
GGTCCATTGCA -> GTCCATTGCAT
GTCCATTGCAT -> TCCATTGCATC
TCCATTGCATC -> CCATTGCATCA
CCATTGCATCA -> CATTGCATCAG
CATTGCATCAG -> ATTGCATCAGC
ATTGCATCAGC -> TTGCATCAGCA
TTGCATCAGCA -> TGCATCAGCAC
TGCATCAGCAC -> GCATCAGCACG
GCATCAGCACG -> CATCAGCACGA
CATCAGCACGA -> ATCAGCACGAT
ATCAGCACGAT -> TCAGCACGATT
TCAGCACGATT -> CAGCACGATTG
CAGCACGATTG -> AGCACGATTGA
AGCACGATTGA -> GCACGATTGAC
GCACGATTGAC -> CACGATTGACG
CACGATTGACG -> ACGATTGACGA
ACGATTGACGA -> CGATTGACGAG
CGATTGACGAG -> GATTGACGAGT
GATTGACGAGT -> ATTGACGAGTG
ATTGACGAGTG -> TTGACGAGTGA
TTGACGAGTGA -> TGACGAGTGAT
TGACGAGTGAT -> GACGAGTGATT
GACGAGTGATT -> ACGAGTGATTG
ACGAGTGATTG -> CGAGTGATTGT
CGAGTGATTGT -> GAGTGATTGTA
GAGTGATTGTA -> AGTGATTGTAA
AGTGATTGTAA -> GTGATTGTAAT
GTGATTGTAAT -> TGATTGTAATT
TGATTGTAATT -> GATTGTAATTT
GATTGTAATTT -> ATTGTAATTTC
ATTGTAATTTC -> TTGTAATTTCA
TTGTAATTTCA -> TGTAATTTCAG
TGTAATTTCAG -> GTAATTTCAGC
GTAATTTCAGC -> TAATTTCAGCG
TAATTTCAGCG -> AATTTCAGCGG
AATTTCAGCGG -> ATTTCAGCGGT
ATTTCAGCGGT -> TTTCAGCGGTC
TTTCAGCGGTC -> TTCAGCGGTCT
TTCAGCGGTCT -> TCAGCGGTCTG
TCAGCGGTCTG -> CAGCGGTCTGC
CAGCGGTCTGC -> AGCGGTCTGCT
AGCGGTCTGCT -> GCGGTCTGCTC
GCGGTCTGCTC -> CGGTCTGCTCA
CGGTCTGCTCA -> GGTCTGCTCAG
GGTCTGCTCAG -> GTCTGCTCAGC
GTCTGCTCAGC -> TCTGCTCAGCT
TCTGCTCAGCT -> CTGCTCAGCTG
CTGCTCAGCTG -> TGCTCAGCTGT
TGCTCAGCTGT -> GCTCAGCTGTT
GCTCAGCTGTT -> CTCAGCTGTTC
CTCAGCTGTTC -> TCAGCTGTTCC
TCAGCTGTTCC -> CAGCTGTTCCA
CAGCTGTTCCA -> AGCTGTTCCAT
AGCTGTTCCAT -> GCTGTTCCATC
GCTGTTCCATC -> CTGTTCCATCA
CTGTTCCATCA -> TGTTCCATCAA
TGTTCCATCAA -> GTTCCATCAAC
GTTCCATCAAC -> TTCCATCAACT
TTCCATCAACT -> TCCATCAACTT
TCCATCAACTT -> CCATCAACTTG
CCATCAACTTG -> CATCAACTTGG
CATCAACTTGG -> ATCAACTTGGC
ATCAACTTGGC -> TCAACTTGGCA
TCAACTTGGCA -> CAACTTGGCAC
CAACTTGGCAC -> AACTTGGCACT
AACTTGGCACT -> ACTTGGCACTT
ACTTGGCACTT -> CTTGGCACTTC
CTTGGCACTTC -> TTGGCACTTCT
TTGGCACTTCT -> TGGCACTTCTC
TGGCACTTCTC -> GGCACTTCTCT
GGCACTTCTCT -> GCACTTCTCTC
GCACTTCTCTC -> CACTTCTCTCC
CACTTCTCTCC -> ACTTCTCTCCA
ACTTCTCTCCA -> CTTCTCTCCAC
CTTCTCTCCAC -> TTCTCTCCACT,TTCTCTCCACC
TTCTCTCCACT -> TCTCTCCACTG
TCTCTCCACTG -> CTCTCCACTGC
CTCTCCACTGC -> TCTCCACTGCC
TCTCCACTGCC -> CTCCACTGCCG
CTCCACTGCCG -> TCCACTGCCGT
TCCACTGCCGT -> CCACTGCCGTG
CCACTGCCGTG -> CACTGCCGTGA
CACTGCCGTGA -> ACTGCCGTGAA
ACTGCCGTGAA -> CTGCCGTGAAT
CTGCCGTGAAT -> TGCCGTGAATC
TGCCGTGAATC -> GCCGTGAATCT
GCCGTGAATCT -> CCGTGAATCTG
CCGTGAATCTG -> CGTGAATCTGC
CGTGAATCTGC -> GTGAATCTGCC
GTGAATCTGCC -> TGAATCTGCCG
TGAATCTGCCG -> GAATCTGCCGT
GAATCTGCCGT -> AATCTGCCGTG
AATCTGCCGTG -> ATCTGCCGTGC
ATCTGCCGTGC -> TCTGCCGTGCA
TCTGCCGTGCA -> CTGCCGTGCAG
CTGCCGTGCAG -> TGCCGTGCAGG
TGCCGTGCAGG -> GCCGTGCAGGG
GCCGTGCAGGG -> CCGTGCAGGGG
CCGTGCAGGGG -> CGTGCAGGGGA
CGTGCAGGGGA -> GTGCAGGGGAA
GTGCAGGGGAA -> TGCAGGGGAAT
TGCAGGGGAAT -> GCAGGGGAATT
GCAGGGGAATT -> CAGGGGAATTC
CAGGGGAATTC -> AGGGGAATTCT
AGGGGAATTCT -> GGGGAATTCTT
GGGGAATTCTT -> GGGAATTCTTA
GGGAATTCTTA -> GGAATTCTTAG
GGAATTCTTAG -> GAATTCTTAGG
GAATTCTTAGG -> AATTCTTAGGC
AATTCTTAGGC -> ATTCTTAGGCA
ATTCTTAGGCA -> TTCTTAGGCAG
TTCTTAGGCAG -> TCTTAGGCAGA
TCTTAGGCAGA -> CTTAGGCAGAC
CTTAGGCAGAC -> TTAGGCAGACG
TTAGGCAGACG -> TAGGCAGACGC
TAGGCAGACGC -> AGGCAGACGCT
AGGCAGACGCT -> GGCAGACGCTT
GGCAGACGCTT -> GCAGACGCTTC
GCAGACGCTTC -> CAGACGCTTCA
CAGACGCTTCA -> AGACGCTTCAA
AGACGCTTCAA -> GACGCTTCAAA
GACGCTTCAAA -> ACGCTTCAAAC
ACGCTTCAAAC -> CGCTTCAAACG
CGCTTCAAACG -> GCTTCAAACGA
GCTTCAAACGA -> CTTCAAACGAG
CTTCAAACGAG -> TTCAAACGAGC
TTCAAACGAGC -> TCAAACGAGCG
TCAAACGAGCG -> CAAACGAGCGG
CAAACGAGCGG -> AAACGAGCGGA
AAACGAGCGGA -> AACGAGCGGAG
AACGAGCGGAG -> ACGAGCGGAGT
ACGAGCGGAGT -> CGAGCGGAGTT
CGAGCGGAGTT -> GAGCGGAGTTT
GAGCGGAGTTT -> AGCGGAGTTTG
AGCGGAGTTTG -> GCGGAGTTTGG
GCGGAGTTTGG -> CGGAGTTTGGA
CGGAGTTTGGA -> GGAGTTTGGAG
GGAGTTTGGAG -> GAGTTTGGAGG
GAGTTTGGAGG -> AGTTTGGAGGT
AGTTTGGAGGT -> GTTTGGAGGTG
GTTTGGAGGTG -> TTTGGAGGTGG
TTTGGAGGTGG -> TTGGAGGTGGG
TTGGAGGTGGG -> TGGAGGTGGGC
TGGAGGTGGGC -> GGAGGTGGGCG
GGAGGTGGGCG -> GAGGTGGGCGA
GAGGTGGGCGA -> AGGTGGGCGAG
AGGTGGGCGAG -> GGTGGGCGAGC
GGTGGGCGAGC -> GTGGGCGAGCT
GTGGGCGAGCT -> TGGGCGAGCTT
TGGGCGAGCTT -> GGGCGAGCTTC
GGGCGAGCTTC -> GGCGAGCTTCG
GGCGAGCTTCG -> GCGAGCTTCGG
GCGAGCTTCGG -> CGAGCTTCGGA
CGAGCTTCGGA -> GAGCTTCGGAG
GAGCTTCGGAG -> AGCTTCGGAGC
AGCTTCGGAGC -> GCTTCGGAGCT
GCTTCGGAGCT -> CTTCGGAGCTG
CTTCGGAGCTG -> TTCGGAGCTGC
TTCGGAGCTGC -> TCGGAGCTGCG
TCGGAGCTGCG -> CGGAGCTGCGT
CGGAGCTGCGT -> GGAGCTGCGTG
GGAGCTGCGTG -> GAGCTGCGTGA
GAGCTGCGTGA -> AGCTGCGTGAG
AGCTGCGTGAG -> GCTGCGTGAGT
GCTGCGTGAGT -> CTGCGTGAGTT
CTGCGTGAGTT -> TGCGTGAGTTC
TGCGTGAGTTC -> GCGTGAGTTCG
GCGTGAGTTCG -> CGTGAGTTCGT
CGTGAGTTCGT -> GTGAGTTCGTC
GTGAGTTCGTC -> TGAGTTCGTCG
TGAGTTCGTCG -> GAGTTCGTCGC
GAGTTCGTCGC -> AGTTCGTCGCC
AGTTCGTCGCC -> GTTCGTCGCCA
GTTCGTCGCCA -> TTCGTCGCCAC
TTCGTCGCCAC -> TCGTCGCCACA
TCGTCGCCACA -> CGTCGCCACAG
CGTCGCCACAG -> GTCGCCACAGC
GTCGCCACAGC -> TCGCCACAGCC
TCGCCACAGCC -> CGCCACAGCCG
CGCCACAGCCG -> GCCACAGCCGA
GCCACAGCCGA -> CCACAGCCGAC
CCACAGCCGAC -> CACAGCCGACG
CACAGCCGACG -> ACAGCCGACGT
ACAGCCGACGT -> CAGCCGACGTG
CAGCCGACGTG -> AGCCGACGTGG
AGCCGACGTGG -> GCCGACGTGGG
GCCGACGTGGG -> CCGACGTGGGA
CCGACGTGGGA -> CGACGTGGGAG
CGACGTGGGAG -> GACGTGGGAGG
GACGTGGGAGG -> ACGTGGGAGGA
ACGTGGGAGGA -> CGTGGGAGGAG
CGTGGGAGGAG -> GTGGGAGGAGA
GTGGGAGGAGA -> TGGGAGGAGAG
TGGGAGGAGAG -> GGGAGGAGAGT
GGGAGGAGAGT -> GGAGGAGAGTG
GGAGGAGAGTG -> GAGGAGAGTGT
GAGGAGAGTGT -> AGGAGAGTGTT
AGGAGAGTGTT -> GGAGAGTGTTT
GGAGAGTGTTT -> GAGAGTGTTTG
GAGAGTGTTTG -> AGAGTGTTTGC
AGAGTGTTTGC -> GAGTGTTTGCA
GAGTGTTTGCA -> AGTGTTTGCAC
AGTGTTTGCAC -> GTGTTTGCACC
GTGTTTGCACC -> TGTTTGCACCC
TGTTTGCACCC -> GTTTGCACCCT
GTTTGCACCCT -> TTTGCACCCTA
TTTGCACCCTA -> TTGCACCCTAA
TTGCACCCTAA -> TGCACCCTAAG
TGCACCCTAAG -> GCACCCTAAGA
GCACCCTAAGA -> CACCCTAAGAA
CACCCTAAGAA -> ACCCTAAGAAA
ACCCTAAGAAA -> CCCTAAGAAAG
CCCTAAGAAAG -> CCTAAGAAAGC
CCTAAGAAAGC -> CTAAGAAAGCG
CTAAGAAAGCG -> TAAGAAAGCGT
TAAGAAAGCGT -> AAGAAAGCGTG
AAGAAAGCGTG -> AGAAAGCGTGT
AGAAAGCGTGT -> GAAAGCGTGTG
GAAAGCGTGTG -> AAAGCGTGTGT
AAAGCGTGTGT -> AAGCGTGTGTT
AAGCGTGTGTT -> AGCGTGTGTTC
AGCGTGTGTTC -> GCGTGTGTTCA
GCGTGTGTTCA -> CGTGTGTTCAA
CGTGTGTTCAA -> GTGTGTTCAAG
GTGTGTTCAAG -> TGTGTTCAAGG
TGTGTTCAAGG -> GTGTTCAAGGT
GTGTTCAAGGT -> TGTTCAAGGTT
TGTTCAAGGTT -> GTTCAAGGTTT
GTTCAAGGTTT -> TTCAAGGTTTG
TTCAAGGTTTG -> TCAAGGTTTGC
TCAAGGTTTGC -> CAAGGTTTGCG
CAAGGTTTGCG -> AAGGTTTGCGC
AAGGTTTGCGC -> AGGTTTGCGCG
AGGTTTGCGCG -> GGTTTGCGCGG
GGTTTGCGCGG -> GTTTGCGCGGG
GTTTGCGCGGG -> TTTGCGCGGGT
TTTGCGCGGGT -> TTGCGCGGGTC
TTGCGCGGGTC -> TGCGCGGGTCG
TGCGCGGGTCG -> GCGCGGGTCGT
GCGCGGGTCGT -> CGCGGGTCGTG
CGCGGGTCGTG -> GCGGGTCGTGT
GCGGGTCGTGT -> CGGGTCGTGTT
CGGGTCGTGTT -> GGGTCGTGTTA
GGGTCGTGTTA -> GGTCGTGTTAA
GGTCGTGTTAA -> GTCGTGTTAAA
GTCGTGTTAAA -> TCGTGTTAAAG
TCGTGTTAAAG -> CGTGTTAAAGT
CGTGTTAAAGT -> GTGTTAAAGTC
GTGTTAAAGTC -> TGTTAAAGTCG
TGTTAAAGTCG -> GTTAAAGTCGT
GTTAAAGTCGT -> TTAAAGTCGTG
TTAAAGTCGTG -> TAAAGTCGTGT
TAAAGTCGTGT -> AAAGTCGTGTC
AAAGTCGTGTC -> AAGTCGTGTCC
AAGTCGTGTCC -> AGTCGTGTCCT
AGTCGTGTCCT -> GTCGTGTCCTC
GTCGTGTCCTC -> TCGTGTCCTCG
TCGTGTCCTCG -> CGTGTCCTCGT
CGTGTCCTCGT -> GTGTCCTCGTA
GTGTCCTCGTA -> TGTCCTCGTAG
TGTCCTCGTAG -> GTCCTCGTAGG
GTCCTCGTAGG -> TCCTCGTAGGA
TCCTCGTAGGA -> CCTCGTAGGAG
CCTCGTAGGAG -> CTCGTAGGAGA
CTCGTAGGAGA -> TCGTAGGAGAA
TCGTAGGAGAA -> CGTAGGAGAAG
CGTAGGAGAAG -> GTAGGAGAAGA
GTAGGAGAAGA -> TAGGAGAAGAG
TAGGAGAAGAG -> AGGAGAAGAGA
AGGAGAAGAGA -> GGAGAAGAGAA
GGAGAAGAGAA -> GAGAAGAGAAG
GAGAAGAGAAG -> AGAAGAGAAGG
AGAAGAGAAGG -> GAAGAGAAGGA
GAAGAGAAGGA -> AAGAGAAGGAG
AAGAGAAGGAG -> AGAGAAGGAGA
AGAGAAGGAGA -> GAGAAGGAGAC
GAGAAGGAGAC -> AGAAGGAGACC
AGAAGGAGACC -> GAAGGAGACCT
GAAGGAGACCT -> AAGGAGACCTG
AAGGAGACCTG -> AGGAGACCTGT
AGGAGACCTGT -> GGAGACCTGTG
GGAGACCTGTG -> GAGACCTGTGG
GAGACCTGTGG -> AGACCTGTGGA
AGACCTGTGGA -> GACCTGTGGAA
GACCTGTGGAA -> ACCTGTGGAAC
ACCTGTGGAAC -> CCTGTGGAACG
CCTGTGGAACG -> CTGTGGAACGA
CTGTGGAACGA -> TGTGGAACGAG
TGTGGAACGAG -> GTGGAACGAGC
GTGGAACGAGC -> TGGAACGAGCG
TGGAACGAGCG -> GGAACGAGCGT
GGAACGAGCGT -> GAACGAGCGTC
GAACGAGCGTC -> AACGAGCGTCA
AACGAGCGTCA -> ACGAGCGTCAG
ACGAGCGTCAG -> CGAGCGTCAGA
CGAGCGTCAGA -> GAGCGTCAGAG
GAGCGTCAGAG -> AGCGTCAGAGA
AGCGTCAGAGA -> GCGTCAGAGAA
GCGTCAGAGAA -> CGTCAGAGAAG
CGTCAGAGAAG -> GTCAGAGAAGC
GTCAGAGAAGC -> TCAGAGAAGCA
TCAGAGAAGCA -> CAGAGAAGCAG
CAGAGAAGCAG -> AGAGAAGCAGC
AGAGAAGCAGC -> GAGAAGCAGCC
GAGAAGCAGCC -> AGAAGCAGCCT
AGAAGCAGCCT -> GAAGCAGCCTA
GAAGCAGCCTA -> AAGCAGCCTAT
AAGCAGCCTAT -> AGCAGCCTATG
AGCAGCCTATG -> GCAGCCTATGT
GCAGCCTATGT -> CAGCCTATGTC
CAGCCTATGTC -> AGCCTATGTCC
AGCCTATGTCC -> GCCTATGTCCT
GCCTATGTCCT -> CCTATGTCCTA
CCTATGTCCTA -> CTATGTCCTAC
CTATGTCCTAC -> TATGTCCTACA
TATGTCCTACA -> ATGTCCTACAT
ATGTCCTACAT -> TGTCCTACATA
TGTCCTACATA -> GTCCTACATAT
GTCCTACATAT -> TCCTACATATA
TCCTACATATA -> CCTACATATAA
CCTACATATAA -> CTACATATAAA
CTACATATAAA -> TACATATAAAG
TACATATAAAG -> ACATATAAAGT
ACATATAAAGT -> CATATAAAGTG
CATATAAAGTG -> ATATAAAGTGA
ATATAAAGTGA -> TATAAAGTGAA
TATAAAGTGAA -> ATAAAGTGAAG
ATAAAGTGAAG -> TAAAGTGAAGA
TAAAGTGAAGA -> AAAGTGAAGAG
AAAGTGAAGAG -> AAGTGAAGAGA
AAGTGAAGAGA -> AGTGAAGAGAT
AGTGAAGAGAT -> GTGAAGAGATA
GTGAAGAGATA -> TGAAGAGATAG
TGAAGAGATAG -> GAAGAGATAGA
GAAGAGATAGA -> AAGAGATAGAT
AAGAGATAGAT -> AGAGATAGATT
AGAGATAGATT -> GAGATAGATTA
GAGATAGATTA -> AGATAGATTAC
AGATAGATTAC -> GATAGATTACC
GATAGATTACC -> ATAGATTACCG
ATAGATTACCG -> TAGATTACCGG
TAGATTACCGG -> AGATTACCGGA
AGATTACCGGA -> GATTACCGGAT
GATTACCGGAT -> ATTACCGGATG
ATTACCGGATG -> TTACCGGATGC
TTACCGGATGC -> TACCGGATGCA
TACCGGATGCA -> ACCGGATGCAT
ACCGGATGCAT -> CCGGATGCATC
CCGGATGCATC -> CGGATGCATCT
CGGATGCATCT -> GGATGCATCTT
GGATGCATCTT -> GATGCATCTTG
GATGCATCTTG -> ATGCATCTTGG
ATGCATCTTGG -> TGCATCTTGGG
TGCATCTTGGG -> GCATCTTGGGG
GCATCTTGGGG -> CATCTTGGGGG
CATCTTGGGGG -> ATCTTGGGGGT
ATCTTGGGGGT -> TCTTGGGGGTA
TCTTGGGGGTA -> CTTGGGGGTAA
CTTGGGGGTAA -> TTGGGGGTAAT
TTGGGGGTAAT -> TGGGGGTAATA
TGGGGGTAATA -> GGGGGTAATAG
GGGGGTAATAG -> GGGGTAATAGC
GGGGTAATAGC -> GGGTAATAGCC
GGGTAATAGCC -> GGTAATAGCCT
GGTAATAGCCT -> GTAATAGCCTA
GTAATAGCCTA -> TAATAGCCTAA
TAATAGCCTAA -> AATAGCCTAAT
AATAGCCTAAT -> ATAGCCTAATG
ATAGCCTAATG -> TAGCCTAATGT
TAGCCTAATGT -> AGCCTAATGTC
AGCCTAATGTC -> GCCTAATGTCG
GCCTAATGTCG -> CCTAATGTCGG
CCTAATGTCGG -> CTAATGTCGGC
CTAATGTCGGC -> TAATGTCGGCC
TAATGTCGGCC -> AATGTCGGCCT
AATGTCGGCCT -> ATGTCGGCCTT
ATGTCGGCCTT -> TGTCGGCCTTG
TGTCGGCCTTG -> GTCGGCCTTGT
GTCGGCCTTGT -> TCGGCCTTGTG
TCGGCCTTGTG -> CGGCCTTGTGT
CGGCCTTGTGT -> GGCCTTGTGTC
GGCCTTGTGTC -> GCCTTGTGTCC
GCCTTGTGTCC -> CCTTGTGTCCA
CCTTGTGTCCA -> CTTGTGTCCAG
CTTGTGTCCAG -> TTGTGTCCAGA
TTGTGTCCAGA -> TGTGTCCAGAT
TGTGTCCAGAT -> GTGTCCAGATT
GTGTCCAGATT -> TGTCCAGATTG
TGTCCAGATTG -> GTCCAGATTGG
GTCCAGATTGG -> TCCAGATTGGA
TCCAGATTGGA -> CCAGATTGGAT
CCAGATTGGAT -> CAGATTGGATT
CAGATTGGATT -> AGATTGGATTT
AGATTGGATTT -> GATTGGATTTT
GATTGGATTTT -> ATTGGATTTTG
ATTGGATTTTG -> TTGGATTTTGT
TTGGATTTTGT -> TGGATTTTGTT
TGGATTTTGTT -> GGATTTTGTTA
GGATTTTGTTA -> GATTTTGTTAC
GATTTTGTTAC -> ATTTTGTTACG
ATTTTGTTACG -> TTTTGTTACGA
TTTTGTTACGA -> TTTGTTACGAT
TTTGTTACGAT -> TTGTTACGATG
TTGTTACGATG -> TGTTACGATGT
TGTTACGATGT -> GTTACGATGTA
GTTACGATGTA -> TTACGATGTAA
TTACGATGTAA -> TACGATGTAAT
TACGATGTAAT -> ACGATGTAATG
ACGATGTAATG -> CGATGTAATGT
CGATGTAATGT -> GATGTAATGTA
GATGTAATGTA -> ATGTAATGTAT
ATGTAATGTAT -> TGTAATGTATC
TGTAATGTATC -> GTAATGTATCT
GTAATGTATCT -> TAATGTATCTC
TAATGTATCTC -> AATGTATCTCT
AATGTATCTCT -> ATGTATCTCTG
ATGTATCTCTG -> TGTATCTCTGC
TGTATCTCTGC -> GTATCTCTGCG
GTATCTCTGCG -> TATCTCTGCGC
TATCTCTGCGC -> ATCTCTGCGCT
ATCTCTGCGCT -> TCTCTGCGCTG
TCTCTGCGCTG -> CTCTGCGCTGT
CTCTGCGCTGT -> TCTGCGCTGTT
TCTGCGCTGTT -> CTGCGCTGTTA
CTGCGCTGTTA -> TGCGCTGTTAG
TGCGCTGTTAG -> GCGCTGTTAGG
GCGCTGTTAGG -> CGCTGTTAGGC
CGCTGTTAGGC -> GCTGTTAGGCG
GCTGTTAGGCG -> CTGTTAGGCGC
CTGTTAGGCGC -> TGTTAGGCGCT
TGTTAGGCGCT -> GTTAGGCGCTA
GTTAGGCGCTA -> TTAGGCGCTAA
TTAGGCGCTAA -> TAGGCGCTAAT
TAGGCGCTAAT -> AGGCGCTAATA
AGGCGCTAATA -> GGCGCTAATAC
GGCGCTAATAC -> GCGCTAATACC
GCGCTAATACC -> CGCTAATACCG
CGCTAATACCG -> GCTAATACCGC
GCTAATACCGC -> CTAATACCGCA
CTAATACCGCA -> TAATACCGCAG
TAATACCGCAG -> AATACCGCAGA
AATACCGCAGA -> ATACCGCAGAG
ATACCGCAGAG -> TACCGCAGAGT
TACCGCAGAGT -> ACCGCAGAGTA
ACCGCAGAGTA -> CCGCAGAGTAG
CCGCAGAGTAG -> CGCAGAGTAGA
CGCAGAGTAGA -> GCAGAGTAGAA
GCAGAGTAGAA -> CAGAGTAGAAT
CAGAGTAGAAT -> AGAGTAGAATA
AGAGTAGAATA -> GAGTAGAATAA
GAGTAGAATAA -> AGTAGAATAAA
AGTAGAATAAA -> GTAGAATAAAC
GTAGAATAAAC -> TAGAATAAACA
TAGAATAAACA -> AGAATAAACAG
AGAATAAACAG -> GAATAAACAGT
GAATAAACAGT -> AATAAACAGTG
AATAAACAGTG -> ATAAACAGTGT
ATAAACAGTGT -> TAAACAGTGTT
TAAACAGTGTT -> AAACAGTGTTT
AAACAGTGTTT -> AACAGTGTTTC
AACAGTGTTTC -> ACAGTGTTTCT
ACAGTGTTTCT -> CAGTGTTTCTT
CAGTGTTTCTT -> AGTGTTTCTTC
AGTGTTTCTTC -> GTGTTTCTTCT
GTGTTTCTTCT -> TGTTTCTTCTA
TGTTTCTTCTA -> GTTTCTTCTAA
GTTTCTTCTAA -> TTTCTTCTAAC
TTTCTTCTAAC -> TTCTTCTAACC
TTCTTCTAACC -> TCTTCTAACCC
TCTTCTAACCC -> CTTCTAACCCG
CTTCTAACCCG -> TTCTAACCCGC
TTCTAACCCGC -> TCTAACCCGCT
TCTAACCCGCT -> CTAACCCGCTT
CTAACCCGCTT -> TAACCCGCTTT
TAACCCGCTTT -> AACCCGCTTTA
AACCCGCTTTA -> ACCCGCTTTAC
ACCCGCTTTAC -> CCCGCTTTACG
CCCGCTTTACG -> CCGCTTTACGT
CCGCTTTACGT -> CGCTTTACGTG
CGCTTTACGTG -> GCTTTACGTGC
GCTTTACGTGC -> CTTTACGTGCT
CTTTACGTGCT -> TTTACGTGCTC
TTTACGTGCTC -> TTACGTGCTCC
TTACGTGCTCC -> TACGTGCTCCC
TACGTGCTCCC -> ACGTGCTCCCC
ACGTGCTCCCC -> CGTGCTCCCCG
CGTGCTCCCCG -> GTGCTCCCCGT
GTGCTCCCCGT -> TGCTCCCCGTG
TGCTCCCCGTG -> GCTCCCCGTGG
GCTCCCCGTGG -> CTCCCCGTGGA
CTCCCCGTGGA -> TCCCCGTGGAA
TCCCCGTGGAA -> CCCCGTGGAAT
CCCCGTGGAAT -> CCCGTGGAATA
CCCGTGGAATA -> CCGTGGAATAT
CCGTGGAATAT -> CGTGGAATATT
CGTGGAATATT -> GTGGAATATTG
GTGGAATATTG -> TGGAATATTGC
TGGAATATTGC -> GGAATATTGCC
GGAATATTGCC -> GAATATTGCCA
GAATATTGCCA -> AATATTGCCAG
AATATTGCCAG -> ATATTGCCAGG
ATATTGCCAGG -> TATTGCCAGGA
TATTGCCAGGA -> ATTGCCAGGAG
ATTGCCAGGAG -> TTGCCAGGAGG
TTGCCAGGAGG -> TGCCAGGAGGA
TGCCAGGAGGA -> GCCAGGAGGAG
GCCAGGAGGAG -> CCAGGAGGAGA
CCAGGAGGAGA -> CAGGAGGAGAT
CAGGAGGAGAT -> AGGAGGAGATC
AGGAGGAGATC -> GGAGGAGATCC
GGAGGAGATCC -> GAGGAGATCCG
GAGGAGATCCG -> AGGAGATCCGC
AGGAGATCCGC -> GGAGATCCGCC
GGAGATCCGCC -> GAGATCCGCCG
GAGATCCGCCG -> AGATCCGCCGG
AGATCCGCCGG -> GATCCGCCGGG
GATCCGCCGGG -> ATCCGCCGGGT
ATCCGCCGGGT -> TCCGCCGGGTT
TCCGCCGGGTT -> CCGCCGGGTTG
CCGCCGGGTTG -> CGCCGGGTTGA
CGCCGGGTTGA -> GCCGGGTTGAT
GCCGGGTTGAT -> CCGGGTTGATC
CCGGGTTGATC -> CGGGTTGATCG
CGGGTTGATCG -> GGGTTGATCGT
GGGTTGATCGT -> GGTTGATCGTA
GGTTGATCGTA -> GTTGATCGTAG
GTTGATCGTAG -> TTGATCGTAGT
TTGATCGTAGT -> TGATCGTAGTG
TGATCGTAGTG -> GATCGTAGTGC
GATCGTAGTGC -> ATCGTAGTGCT
ATCGTAGTGCT -> TCGTAGTGCTT
TCGTAGTGCTT -> CGTAGTGCTTT
CGTAGTGCTTT -> GTAGTGCTTTC
GTAGTGCTTTC -> TAGTGCTTTCC
TAGTGCTTTCC -> AGTGCTTTCCT
AGTGCTTTCCT -> GTGCTTTCCTA
GTGCTTTCCTA -> TGCTTTCCTAT
TGCTTTCCTAT -> GCTTTCCTATG
GCTTTCCTATG -> CTTTCCTATGT
CTTTCCTATGT -> TTTCCTATGTT
TTTCCTATGTT -> TTCCTATGTTG
TTCCTATGTTG -> TCCTATGTTGT
TCCTATGTTGT -> CCTATGTTGTG
CCTATGTTGTG -> CTATGTTGTGG
CTATGTTGTGG -> TATGTTGTGGG
TATGTTGTGGG -> ATGTTGTGGGT
ATGTTGTGGGT -> TGTTGTGGGTT
TGTTGTGGGTT -> GTTGTGGGTTA
GTTGTGGGTTA -> TTGTGGGTTAG
TTGTGGGTTAG -> TGTGGGTTAGT
TGTGGGTTAGT -> GTGGGTTAGTA
GTGGGTTAGTA -> TGGGTTAGTAC
TGGGTTAGTAC -> GGGTTAGTACC
GGGTTAGTACC -> GGTTAGTACCG
GGTTAGTACCG -> GTTAGTACCGT
GTTAGTACCGT -> TTAGTACCGTA
TTAGTACCGTA -> TAGTACCGTAG
TAGTACCGTAG -> AGTACCGTAGG
AGTACCGTAGG -> GTACCGTAGGA
GTACCGTAGGA -> TACCGTAGGAC
TACCGTAGGAC -> ACCGTAGGACA
ACCGTAGGACA -> CCGTAGGACAT
CCGTAGGACAT -> CGTAGGACATA
CGTAGGACATA -> GTAGGACATAC
GTAGGACATAC -> TAGGACATACC
TAGGACATACC -> AGGACATACCT
AGGACATACCT -> GGACATACCTC
GGACATACCTC -> GACATACCTCT
GACATACCTCT -> ACATACCTCTT
ACATACCTCTT -> CATACCTCTTG
CATACCTCTTG -> ATACCTCTTGT
ATACCTCTTGT -> TACCTCTTGTG
TACCTCTTGTG -> ACCTCTTGTGT
ACCTCTTGTGT -> CCTCTTGTGTA
CCTCTTGTGTA -> CTCTTGTGTAG
CTCTTGTGTAG -> TCTTGTGTAGT
TCTTGTGTAGT -> CTTGTGTAGTT
CTTGTGTAGTT -> TTGTGTAGTTG
TTGTGTAGTTG -> TGTGTAGTTGC
TGTGTAGTTGC -> GTGTAGTTGCA
GTGTAGTTGCA -> TGTAGTTGCAT
TGTAGTTGCAT -> GTAGTTGCATG
GTAGTTGCATG -> TAGTTGCATGG
TAGTTGCATGG -> AGTTGCATGGA
AGTTGCATGGA -> GTTGCATGGAA
GTTGCATGGAA -> TTGCATGGAAG
TTGCATGGAAG -> TGCATGGAAGA
TGCATGGAAGA -> GCATGGAAGAT
GCATGGAAGAT -> CATGGAAGATA
CATGGAAGATA -> ATGGAAGATAG
ATGGAAGATAG -> TGGAAGATAGA
TGGAAGATAGA -> GGAAGATAGAG
GGAAGATAGAG -> GAAGATAGAGG
GAAGATAGAGG -> AAGATAGAGGG
AAGATAGAGGG -> AGATAGAGGGA
AGATAGAGGGA -> GATAGAGGGAG
GATAGAGGGAG -> ATAGAGGGAGT
ATAGAGGGAGT -> TAGAGGGAGTT
TAGAGGGAGTT -> AGAGGGAGTTT
AGAGGGAGTTT -> GAGGGAGTTTG
GAGGGAGTTTG -> AGGGAGTTTGC
AGGGAGTTTGC -> GGGAGTTTGCG
GGGAGTTTGCG -> GGAGTTTGCGT
GGAGTTTGCGT -> GAGTTTGCGTA
GAGTTTGCGTA -> AGTTTGCGTAG
AGTTTGCGTAG -> GTTTGCGTAGG
GTTTGCGTAGG -> TTTGCGTAGGC
TTTGCGTAGGC -> TTGCGTAGGCA
TTGCGTAGGCA -> TGCGTAGGCAT
TGCGTAGGCAT -> GCGTAGGCATC
GCGTAGGCATC -> CGTAGGCATCA
CGTAGGCATCA -> GTAGGCATCAA
GTAGGCATCAA -> TAGGCATCAAG
TAGGCATCAAG -> AGGCATCAAGA
AGGCATCAAGA -> GGCATCAAGAG
GGCATCAAGAG -> GCATCAAGAGT
GCATCAAGAGT -> CATCAAGAGTT
CATCAAGAGTT -> ATCAAGAGTTA
ATCAAGAGTTA -> TCAAGAGTTAC
TCAAGAGTTAC -> CAAGAGTTACT
CAAGAGTTACT -> AAGAGTTACTT
AAGAGTTACTT -> AGAGTTACTTG
AGAGTTACTTG -> GAGTTACTTGG
GAGTTACTTGG -> AGTTACTTGGC
AGTTACTTGGC -> GTTACTTGGCC
GTTACTTGGCC -> TTACTTGGCCG
TTACTTGGCCG -> TACTTGGCCGG
TACTTGGCCGG -> ACTTGGCCGGC
ACTTGGCCGGC -> CTTGGCCGGCC
CTTGGCCGGCC -> TTGGCCGGCCC
TTGGCCGGCCC -> TGGCCGGCCCT
TGGCCGGCCCT -> GGCCGGCCCTG
GGCCGGCCCTG -> GCCGGCCCTGC
GCCGGCCCTGC -> CCGGCCCTGCC
CCGGCCCTGCC -> CGGCCCTGCCG
CGGCCCTGCCG -> GGCCCTGCCGA
GGCCCTGCCGA -> GCCCTGCCGAA
GCCCTGCCGAA -> CCCTGCCGAAT
CCCTGCCGAAT -> CCTGCCGAATA
CCTGCCGAATA -> CTGCCGAATAA
CTGCCGAATAA -> TGCCGAATAAT
TGCCGAATAAT -> GCCGAATAATA
GCCGAATAATA -> CCGAATAATAG
CCGAATAATAG -> CGAATAATAGG
CGAATAATAGG -> GAATAATAGGT
GAATAATAGGT -> AATAATAGGTA
AATAATAGGTA -> ATAATAGGTAT
ATAATAGGTAT -> TAATAGGTATG
TAATAGGTATG -> AATAGGTATGA
AATAGGTATGA -> ATAGGTATGAA
ATAGGTATGAA -> TAGGTATGAAT
TAGGTATGAAT -> AGGTATGAATT
AGGTATGAATT -> GGTATGAATTG
GGTATGAATTG -> GTATGAATTGC
GTATGAATTGC -> TATGAATTGCT
TATGAATTGCT -> ATGAATTGCTG
ATGAATTGCTG -> TGAATTGCTGA
TGAATTGCTGA -> GAATTGCTGAT
GAATTGCTGAT -> AATTGCTGATG
AATTGCTGATG -> ATTGCTGATGA
ATTGCTGATGA -> TTGCTGATGAT
TTGCTGATGAT -> TGCTGATGATT
TGCTGATGATT -> GCTGATGATTG
GCTGATGATTG -> CTGATGATTGA
CTGATGATTGA -> TGATGATTGAA
TGATGATTGAA -> GATGATTGAAT
GATGATTGAAT -> ATGATTGAATA
ATGATTGAATA -> TGATTGAATAC
TGATTGAATAC -> GATTGAATACC
GATTGAATACC -> ATTGAATACCC
ATTGAATACCC -> TTGAATACCCT
TTGAATACCCT -> TGAATACCCTG
TGAATACCCTG -> GAATACCCTGG
GAATACCCTGG -> AATACCCTGGA
AATACCCTGGA -> ATACCCTGGAA
ATACCCTGGAA -> TACCCTGGAAT
TACCCTGGAAT -> ACCCTGGAATA
ACCCTGGAATA -> CCCTGGAATAT
CCCTGGAATAT -> CCTGGAATATT
CCTGGAATATT -> CTGGAATATTT
CTGGAATATTT -> TGGAATATTTT
TGGAATATTTT -> GGAATATTTTA
GGAATATTTTA -> GAATATTTTAT
GAATATTTTAT -> AATATTTTATT
AATATTTTATT -> ATATTTTATTG
ATATTTTATTG -> TATTTTATTGG
TATTTTATTGG -> ATTTTATTGGT
ATTTTATTGGT -> TTTTATTGGTC
TTTTATTGGTC -> TTTATTGGTCC
TTTATTGGTCC -> TTATTGGTCCC
TTATTGGTCCC -> TATTGGTCCCT
TATTGGTCCCT -> ATTGGTCCCTT
ATTGGTCCCTT -> TTGGTCCCTTA
TTGGTCCCTTA -> TGGTCCCTTAC
TGGTCCCTTAC -> GGTCCCTTACC
GGTCCCTTACC -> GTCCCTTACCA
GTCCCTTACCA -> TCCCTTACCAG
TCCCTTACCAG -> CCCTTACCAGT
CCCTTACCAGT -> CCTTACCAGTG
CCTTACCAGTG -> CTTACCAGTGG
CTTACCAGTGG -> TTACCAGTGGA
TTACCAGTGGA -> TACCAGTGGAT
TACCAGTGGAT -> ACCAGTGGATC
ACCAGTGGATC -> CCAGTGGATCT
CCAGTGGATCT -> CAGTGGATCTA
CAGTGGATCTA -> AGTGGATCTAT
AGTGGATCTAT -> GTGGATCTATT
GTGGATCTATT -> TGGATCTATTC
TGGATCTATTC -> GGATCTATTCA
GGATCTATTCA -> GATCTATTCAT
GATCTATTCAT -> ATCTATTCATC
ATCTATTCATC -> TCTATTCATCC
TCTATTCATCC -> CTATTCATCCA
CTATTCATCCA -> TATTCATCCAG
TATTCATCCAG -> ATTCATCCAGA
ATTCATCCAGA -> TTCATCCAGAG
TTCATCCAGAG -> TCATCCAGAGA
TCATCCAGAGA -> CATCCAGAGAA
CATCCAGAGAA -> ATCCAGAGAAG
ATCCAGAGAAG -> TCCAGAGAAGC
TCCAGAGAAGC -> CCAGAGAAGCT
CCAGAGAAGCT -> CAGAGAAGCTC
CAGAGAAGCTC -> AGAGAAGCTCC
AGAGAAGCTCC -> GAGAAGCTCCC
GAGAAGCTCCC -> AGAAGCTCCCG
AGAAGCTCCCG -> GAAGCTCCCGG
GAAGCTCCCGG -> AAGCTCCCGGC
AAGCTCCCGGC -> AGCTCCCGGCA
AGCTCCCGGCA -> GCTCCCGGCAT
GCTCCCGGCAT -> CTCCCGGCATA
CTCCCGGCATA -> TCCCGGCATAA
TCCCGGCATAA -> CCCGGCATAAG
CCCGGCATAAG -> CCGGCATAAGT
CCGGCATAAGT -> CGGCATAAGTA
CGGCATAAGTA -> GGCATAAGTAC,GGCATAAGTAT
GGCATAAGTAC -> GCATAAGTACG
GCATAAGTACG -> CATAAGTACGC
CATAAGTACGC -> ATAAGTACGCC
ATAAGTACGCC -> TAAGTACGCCG
TAAGTACGCCG -> AAGTACGCCGT
AAGTACGCCGT -> AGTACGCCGTC
AGTACGCCGTC -> GTACGCCGTCT
GTACGCCGTCT -> TACGCCGTCTA
TACGCCGTCTA -> ACGCCGTCTAC
ACGCCGTCTAC -> CGCCGTCTACA
CGCCGTCTACA -> GCCGTCTACAC
GCCGTCTACAC -> CCGTCTACACT
CCGTCTACACT -> CGTCTACACTC
CGTCTACACTC -> GTCTACACTCA
GTCTACACTCA -> TCTACACTCAT
TCTACACTCAT -> CTACACTCATG
CTACACTCATG -> TACACTCATGG
TACACTCATGG -> ACACTCATGGG
ACACTCATGGG -> CACTCATGGGC
CACTCATGGGC -> ACTCATGGGCG
ACTCATGGGCG -> CTCATGGGCGT
CTCATGGGCGT -> TCATGGGCGTC
TCATGGGCGTC -> CATGGGCGTCG
CATGGGCGTCG -> ATGGGCGTCGG
ATGGGCGTCGG -> TGGGCGTCGGA
TGGGCGTCGGA -> GGGCGTCGGAC
GGGCGTCGGAC -> GGCGTCGGACT
GGCGTCGGACT -> GCGTCGGACTC
GCGTCGGACTC -> CGTCGGACTCC
CGTCGGACTCC -> GTCGGACTCCG
GTCGGACTCCG -> TCGGACTCCGT
TCGGACTCCGT -> CGGACTCCGTC
CGGACTCCGTC -> GGACTCCGTCT
GGACTCCGTCT -> GACTCCGTCTA
GACTCCGTCTA -> ACTCCGTCTAG
ACTCCGTCTAG -> CTCCGTCTAGC
CTCCGTCTAGC -> TCCGTCTAGCC
TCCGTCTAGCC -> CCGTCTAGCCC
CCGTCTAGCCC -> CGTCTAGCCCC
CGTCTAGCCCC -> GTCTAGCCCCT
GTCTAGCCCCT -> TCTAGCCCCTA
TCTAGCCCCTA -> CTAGCCCCTAA
CTAGCCCCTAA -> TAGCCCCTAAC
TAGCCCCTAAC -> AGCCCCTAACC
AGCCCCTAACC -> GCCCCTAACCT
GCCCCTAACCT -> CCCCTAACCTG
CCCCTAACCTG -> CCCTAACCTGC
CCCTAACCTGC -> CCTAACCTGCG
CCTAACCTGCG -> CTAACCTGCGC
CTAACCTGCGC -> TAACCTGCGCA
TAACCTGCGCA -> AACCTGCGCAC
AACCTGCGCAC -> ACCTGCGCACT
ACCTGCGCACT -> CCTGCGCACTT
CCTGCGCACTT -> CTGCGCACTTT
CTGCGCACTTT -> TGCGCACTTTC
TGCGCACTTTC -> GCGCACTTTCG
GCGCACTTTCG -> CGCACTTTCGA
CGCACTTTCGA -> GCACTTTCGAG
GCACTTTCGAG -> CACTTTCGAGG
CACTTTCGAGG -> ACTTTCGAGGG
ACTTTCGAGGG -> CTTTCGAGGGT
CTTTCGAGGGT -> TTTCGAGGGTC
TTTCGAGGGTC -> TTCGAGGGTCA
TTCGAGGGTCA -> TCGAGGGTCAC
TCGAGGGTCAC -> CGAGGGTCACT
CGAGGGTCACT -> GAGGGTCACTT
GAGGGTCACTT -> AGGGTCACTTG
AGGGTCACTTG -> GGGTCACTTGT
GGGTCACTTGT -> GGTCACTTGTC
GGTCACTTGTC -> GTCACTTGTCG
GTCACTTGTCG -> TCACTTGTCGT
TCACTTGTCGT -> CACTTGTCGTC
CACTTGTCGTC -> ACTTGTCGTCT
ACTTGTCGTCT -> CTTGTCGTCTC
CTTGTCGTCTC -> TTGTCGTCTCA
TTGTCGTCTCA -> TGTCGTCTCAC
TGTCGTCTCAC -> GTCGTCTCACC
GTCGTCTCACC -> TCGTCTCACCG
TCGTCTCACCG -> CGTCTCACCGC
CGTCTCACCGC -> GTCTCACCGCT
GTCTCACCGCT -> TCTCACCGCTG
TCTCACCGCTG -> CTCACCGCTGT
CTCACCGCTGT -> TCACCGCTGTA
TCACCGCTGTA -> CACCGCTGTAG
CACCGCTGTAG -> ACCGCTGTAGT
ACCGCTGTAGT -> CCGCTGTAGTG
CCGCTGTAGTG -> CGCTGTAGTGG
CGCTGTAGTGG -> GCTGTAGTGGA
GCTGTAGTGGA -> CTGTAGTGGAA
CTGTAGTGGAA -> TGTAGTGGAAG
TGTAGTGGAAG -> GTAGTGGAAGA
GTAGTGGAAGA -> TAGTGGAAGAA
TAGTGGAAGAA -> AGTGGAAGAAG
AGTGGAAGAAG -> GTGGAAGAAGG
GTGGAAGAAGG -> TGGAAGAAGGC
TGGAAGAAGGC -> GGAAGAAGGCA
GGAAGAAGGCA -> GAAGAAGGCAG
GAAGAAGGCAG -> AAGAAGGCAGC
AAGAAGGCAGC -> AGAAGGCAGCC
AGAAGGCAGCC -> GAAGGCAGCCG
GAAGGCAGCCG -> AAGGCAGCCGT
AAGGCAGCCGT -> AGGCAGCCGTG
AGGCAGCCGTG -> GGCAGCCGTGC
GGCAGCCGTGC -> GCAGCCGTGCC
GCAGCCGTGCC -> CAGCCGTGCCC
CAGCCGTGCCC -> AGCCGTGCCCG
AGCCGTGCCCG -> GCCGTGCCCGA
GCCGTGCCCGA -> CCGTGCCCGAG
CCGTGCCCGAG -> CGTGCCCGAGC
CGTGCCCGAGC -> GTGCCCGAGCG
GTGCCCGAGCG -> TGCCCGAGCGC
TGCCCGAGCGC -> GCCCGAGCGCC
GCCCGAGCGCC -> CCCGAGCGCCA
CCCGAGCGCCA -> CCGAGCGCCAG
CCGAGCGCCAG -> CGAGCGCCAGG
CGAGCGCCAGG -> GAGCGCCAGGC
GAGCGCCAGGC -> AGCGCCAGGCG
AGCGCCAGGCG -> GCGCCAGGCGG
GCGCCAGGCGG -> CGCCAGGCGGG
CGCCAGGCGGG -> GCCAGGCGGGG
GCCAGGCGGGG -> CCAGGCGGGGG
CCAGGCGGGGG -> CAGGCGGGGGT
CAGGCGGGGGT -> AGGCGGGGGTA
AGGCGGGGGTA -> GGCGGGGGTAG
GGCGGGGGTAG -> GCGGGGGTAGA
GCGGGGGTAGA -> CGGGGGTAGAT
CGGGGGTAGAT -> GGGGGTAGATC
GGGGGTAGATC -> GGGGTAGATCG
GGGGTAGATCG -> GGGTAGATCGG
GGGTAGATCGG -> GGTAGATCGGG
GGTAGATCGGG -> GTAGATCGGGG
GTAGATCGGGG -> TAGATCGGGGC
TAGATCGGGGC -> AGATCGGGGCT
AGATCGGGGCT -> GATCGGGGCTT
GATCGGGGCTT -> ATCGGGGCTTA
ATCGGGGCTTA -> TCGGGGCTTAA
TCGGGGCTTAA -> CGGGGCTTAAT
CGGGGCTTAAT -> GGGGCTTAATT
GGGGCTTAATT -> GGGCTTAATTG
GGGCTTAATTG -> GGCTTAATTGT
GGCTTAATTGT -> GCTTAATTGTA
GCTTAATTGTA -> CTTAATTGTAC
CTTAATTGTAC -> TTAATTGTACC
TTAATTGTACC -> TAATTGTACCC
TAATTGTACCC -> AATTGTACCCG
AATTGTACCCG -> ATTGTACCCGA
ATTGTACCCGA -> TTGTACCCGAC
TTGTACCCGAC -> TGTACCCGACT
TGTACCCGACT -> GTACCCGACTC
GTACCCGACTC -> TACCCGACTCC
TACCCGACTCC -> ACCCGACTCCT
ACCCGACTCCT -> CCCGACTCCTT
CCCGACTCCTT -> CCGACTCCTTT
CCGACTCCTTT -> CGACTCCTTTT
CGACTCCTTTT -> GACTCCTTTTA
GACTCCTTTTA -> ACTCCTTTTAG
ACTCCTTTTAG -> CTCCTTTTAGT
CTCCTTTTAGT -> TCCTTTTAGTG
TCCTTTTAGTG -> CCTTTTAGTGT
CCTTTTAGTGT -> CTTTTAGTGTA
CTTTTAGTGTA -> TTTTAGTGTAT
TTTTAGTGTAT -> TTTAGTGTATA
TTTAGTGTATA -> TTAGTGTATAC
TTAGTGTATAC -> TAGTGTATACA
TAGTGTATACA -> AGTGTATACAG
AGTGTATACAG -> GTGTATACAGA
GTGTATACAGA -> TGTATACAGAA
TGTATACAGAA -> GTATACAGAAG
GTATACAGAAG -> TATACAGAAGA
TATACAGAAGA -> ATACAGAAGAG
ATACAGAAGAG -> TACAGAAGAGG
TACAGAAGAGG -> ACAGAAGAGGA
ACAGAAGAGGA -> CAGAAGAGGAA
CAGAAGAGGAA -> AGAAGAGGAAA
AGAAGAGGAAA -> GAAGAGGAAAT
GAAGAGGAAAT -> AAGAGGAAATC
AAGAGGAAATC -> AGAGGAAATCT
AGAGGAAATCT -> GAGGAAATCTT
GAGGAAATCTT -> AGGAAATCTTC
AGGAAATCTTC -> GGAAATCTTCT
GGAAATCTTCT -> GAAATCTTCTC
GAAATCTTCTC -> AAATCTTCTCT
AAATCTTCTCT -> AATCTTCTCTC
AATCTTCTCTC -> ATCTTCTCTCC
ATCTTCTCTCC -> TCTTCTCTCCA
TCTTCTCTCCA -> CTTCTCTCCAC
TTCTCTCCACC -> TCTCTCCACCG
TCTCTCCACCG -> CTCTCCACCGT
CTCTCCACCGT -> TCTCCACCGTC
TCTCCACCGTC -> CTCCACCGTCG
CTCCACCGTCG -> TCCACCGTCGT
TCCACCGTCGT -> CCACCGTCGTG
CCACCGTCGTG -> CACCGTCGTGC
CACCGTCGTGC -> ACCGTCGTGCA
ACCGTCGTGCA -> CCGTCGTGCAC
CCGTCGTGCAC -> CGTCGTGCACG
CGTCGTGCACG -> GTCGTGCACGG
GTCGTGCACGG -> TCGTGCACGGC
TCGTGCACGGC -> CGTGCACGGCA
CGTGCACGGCA -> GTGCACGGCAA
GTGCACGGCAA -> TGCACGGCAAG
TGCACGGCAAG -> GCACGGCAAGA
GCACGGCAAGA -> CACGGCAAGAT
CACGGCAAGAT -> ACGGCAAGATG
ACGGCAAGATG -> CGGCAAGATGC
CGGCAAGATGC -> GGCAAGATGCA
GGCAAGATGCA -> GCAAGATGCAT
GCAAGATGCAT -> CAAGATGCATC
CAAGATGCATC -> AAGATGCATCG
AAGATGCATCG -> AGATGCATCGT
AGATGCATCGT -> GATGCATCGTT
GATGCATCGTT -> ATGCATCGTTA
ATGCATCGTTA -> TGCATCGTTAG
TGCATCGTTAG -> GCATCGTTAGG
GCATCGTTAGG -> CATCGTTAGGT
CATCGTTAGGT -> ATCGTTAGGTA
ATCGTTAGGTA -> TCGTTAGGTAC
TCGTTAGGTAC -> CGTTAGGTACA
CGTTAGGTACA -> GTTAGGTACAG
GTTAGGTACAG -> TTAGGTACAGT
TTAGGTACAGT -> TAGGTACAGTA
TAGGTACAGTA -> AGGTACAGTAG
AGGTACAGTAG -> GGTACAGTAGT
GGTACAGTAGT -> GTACAGTAGTA
GTACAGTAGTA -> TACAGTAGTAC
TACAGTAGTAC -> ACAGTAGTACA
ACAGTAGTACA -> CAGTAGTACAT
CAGTAGTACAT -> AGTAGTACATG
AGTAGTACATG -> GTAGTACATGC
GTAGTACATGC -> TAGTACATGCT
TAGTACATGCT -> AGTACATGCTG
AGTACATGCTG -> GTACATGCTGA
GTACATGCTGA -> TACATGCTGAA
TACATGCTGAA -> ACATGCTGAAA
ACATGCTGAAA -> CATGCTGAAAA
CATGCTGAAAA -> ATGCTGAAAAC
ATGCTGAAAAC -> TGCTGAAAACC
TGCTGAAAACC -> GCTGAAAACCC
GCTGAAAACCC -> CTGAAAACCCA
CTGAAAACCCA -> TGAAAACCCAG
TGAAAACCCAG -> GAAAACCCAGT
GAAAACCCAGT -> AAAACCCAGTA
AAAACCCAGTA -> AAACCCAGTAT
AAACCCAGTAT -> AACCCAGTATT
AACCCAGTATT -> ACCCAGTATTT
ACCCAGTATTT -> CCCAGTATTTG
CCCAGTATTTG -> CCAGTATTTGC
CCAGTATTTGC -> CAGTATTTGCG
CAGTATTTGCG -> AGTATTTGCGG
AGTATTTGCGG -> GTATTTGCGGA
GTATTTGCGGA -> TATTTGCGGAC
TATTTGCGGAC -> ATTTGCGGACC
ATTTGCGGACC -> TTTGCGGACCT
TTTGCGGACCT -> TTGCGGACCTG
TTGCGGACCTG -> TGCGGACCTGG
TGCGGACCTGG -> GCGGACCTGGC
GCGGACCTGGC -> CGGACCTGGCA
CGGACCTGGCA -> GGACCTGGCAT
GGACCTGGCAT -> GACCTGGCATG
GACCTGGCATG -> ACCTGGCATGA
ACCTGGCATGA -> CCTGGCATGAA
CCTGGCATGAA -> CTGGCATGAAC
CTGGCATGAAC -> TGGCATGAACC
TGGCATGAACC -> GGCATGAACCC
GGCATGAACCC -> GCATGAACCCC
GCATGAACCCC -> CATGAACCCCC
CATGAACCCCC -> ATGAACCCCCT
ATGAACCCCCT -> TGAACCCCCTT
TGAACCCCCTT -> GAACCCCCTTG
GAACCCCCTTG -> AACCCCCTTGA
AACCCCCTTGA -> ACCCCCTTGAG
ACCCCCTTGAG -> CCCCCTTGAGC
CCCCCTTGAGC -> CCCCTTGAGCG
CCCCTTGAGCG -> CCCTTGAGCGC
CCCTTGAGCGC -> CCTTGAGCGCG
CCTTGAGCGCG -> CTTGAGCGCGA
CTTGAGCGCGA -> TTGAGCGCGAT
TTGAGCGCGAT -> TGAGCGCGATT
TGAGCGCGATT -> GAGCGCGATTT
GAGCGCGATTT -> AGCGCGATTTC
AGCGCGATTTC -> GCGCGATTTCA
GCGCGATTTCA -> CGCGATTTCAT
CGCGATTTCAT -> GCGATTTCATA
GCGATTTCATA -> CGATTTCATAG
CGATTTCATAG -> GATTTCATAGG
GATTTCATAGG -> ATTTCATAGGG
ATTTCATAGGG -> TTTCATAGGGA
TTTCATAGGGA -> TTCATAGGGAG
TTCATAGGGAG -> TCATAGGGAGC
TCATAGGGAGC -> CATAGGGAGCA
CATAGGGAGCA -> ATAGGGAGCAA
ATAGGGAGCAA -> TAGGGAGCAAC
TAGGGAGCAAC -> AGGGAGCAACC
AGGGAGCAACC -> GGGAGCAACCA
GGGAGCAACCA -> GGAGCAACCAT
GGAGCAACCAT -> GAGCAACCATC
GAGCAACCATC -> AGCAACCATCT
AGCAACCATCT -> GCAACCATCTG
GCAACCATCTG -> CAACCATCTGA
CAACCATCTGA -> AACCATCTGAT
AACCATCTGAT -> ACCATCTGATG
ACCATCTGATG -> CCATCTGATGG
CCATCTGATGG -> CATCTGATGGC
CATCTGATGGC -> ATCTGATGGCT
ATCTGATGGCT -> TCTGATGGCTC
TCTGATGGCTC -> CTGATGGCTCC
CTGATGGCTCC -> TGATGGCTCCC
TGATGGCTCCC -> GATGGCTCCCG
GATGGCTCCCG -> ATGGCTCCCGC
ATGGCTCCCGC -> TGGCTCCCGCC
TGGCTCCCGCC -> GGCTCCCGCCA
GGCTCCCGCCA -> GCTCCCGCCAG
GCTCCCGCCAG -> CTCCCGCCAGG
CTCCCGCCAGG -> TCCCGCCAGGA
TCCCGCCAGGA -> CCCGCCAGGAT
CCCGCCAGGAT -> CCGCCAGGATA
CCGCCAGGATA -> CGCCAGGATAC
CGCCAGGATAC -> GCCAGGATACG
GCCAGGATACG -> CCAGGATACGG
CCAGGATACGG -> CAGGATACGGT
CAGGATACGGT -> AGGATACGGTC
AGGATACGGTC -> GGATACGGTCA
GGATACGGTCA -> GATACGGTCAA
GATACGGTCAA -> ATACGGTCAAC
ATACGGTCAAC -> TACGGTCAACT
TACGGTCAACT -> ACGGTCAACTA
ACGGTCAACTA -> CGGTCAACTAG
CGGTCAACTAG -> GGTCAACTAGA
GGTCAACTAGA -> GTCAACTAGAA
GTCAACTAGAA -> TCAACTAGAAT
TCAACTAGAAT -> CAACTAGAATA
CAACTAGAATA -> AACTAGAATAG
AACTAGAATAG -> ACTAGAATAGT
ACTAGAATAGT -> CTAGAATAGTG
CTAGAATAGTG -> TAGAATAGTGT
TAGAATAGTGT -> AGAATAGTGTG
AGAATAGTGTG -> GAATAGTGTGT
GAATAGTGTGT -> AATAGTGTGTC
AATAGTGTGTC -> ATAGTGTGTCA
ATAGTGTGTCA -> TAGTGTGTCAA
TAGTGTGTCAA -> AGTGTGTCAAT
AGTGTGTCAAT -> GTGTGTCAATG
GTGTGTCAATG -> TGTGTCAATGC
TGTGTCAATGC -> GTGTCAATGCC
GTGTCAATGCC -> TGTCAATGCCG
TGTCAATGCCG -> GTCAATGCCGT
GTCAATGCCGT -> TCAATGCCGTC
TCAATGCCGTC -> CAATGCCGTCT
CAATGCCGTCT -> AATGCCGTCTG
AATGCCGTCTG -> ATGCCGTCTGC
ATGCCGTCTGC -> TGCCGTCTGCG
TGCCGTCTGCG -> GCCGTCTGCGT
GCCGTCTGCGT -> CCGTCTGCGTT
CCGTCTGCGTT -> CGTCTGCGTTG
CGTCTGCGTTG -> GTCTGCGTTGC
GTCTGCGTTGC -> TCTGCGTTGCA
TCTGCGTTGCA -> CTGCGTTGCAC
CTGCGTTGCAC -> TGCGTTGCACA
TGCGTTGCACA -> GCGTTGCACAA
GCGTTGCACAA -> CGTTGCACAAC
CGTTGCACAAC -> GTTGCACAACT
GTTGCACAACT -> TTGCACAACTG
TTGCACAACTG -> TGCACAACTGT
TGCACAACTGT -> GCACAACTGTA
GCACAACTGTA -> CACAACTGTAA
CACAACTGTAA -> ACAACTGTAAA
ACAACTGTAAA -> CAACTGTAAAG
CAACTGTAAAG -> AACTGTAAAGG
AACTGTAAAGG -> ACTGTAAAGGG
ACTGTAAAGGG -> CTGTAAAGGGT
CTGTAAAGGGT -> TGTAAAGGGTG
TGTAAAGGGTG -> GTAAAGGGTGA
GTAAAGGGTGA -> TAAAGGGTGAC
TAAAGGGTGAC -> AAAGGGTGACT
AAAGGGTGACT -> AAGGGTGACTA
AAGGGTGACTA -> AGGGTGACTAC
AGGGTGACTAC -> GGGTGACTACC
GGGTGACTACC -> GGTGACTACCC
GGTGACTACCC -> GTGACTACCCC
GTGACTACCCC -> TGACTACCCCA
TGACTACCCCA -> GACTACCCCAT
GACTACCCCAT -> ACTACCCCATC
ACTACCCCATC -> CTACCCCATCC
CTACCCCATCC -> TACCCCATCCA
TACCCCATCCA -> ACCCCATCCAA
ACCCCATCCAA -> CCCCATCCAAT
CCCCATCCAAT -> CCCATCCAATT
CCCATCCAATT -> CCATCCAATTT
CCATCCAATTT -> CATCCAATTTT
CATCCAATTTT -> ATCCAATTTTC
ATCCAATTTTC -> TCCAATTTTCC
TCCAATTTTCC -> CCAATTTTCCC
CCAATTTTCCC -> CAATTTTCCCT
CAATTTTCCCT -> AATTTTCCCTG
AATTTTCCCTG -> ATTTTCCCTGG
ATTTTCCCTGG -> TTTTCCCTGGG
TTTTCCCTGGG -> TTTCCCTGGGA
TTTCCCTGGGA -> TTCCCTGGGAG
TTCCCTGGGAG -> TCCCTGGGAGA
TCCCTGGGAGA -> CCCTGGGAGAT
CCCTGGGAGAT -> CCTGGGAGATC
CCTGGGAGATC -> CTGGGAGATCG
CTGGGAGATCG -> TGGGAGATCGA
TGGGAGATCGA -> GGGAGATCGAG
GGGAGATCGAG -> GGAGATCGAGG
GGAGATCGAGG -> GAGATCGAGGA
GAGATCGAGGA -> AGATCGAGGAG
AGATCGAGGAG -> GATCGAGGAGG
GATCGAGGAGG -> ATCGAGGAGGC
ATCGAGGAGGC -> TCGAGGAGGCG
TCGAGGAGGCG -> CGAGGAGGCGG
CGAGGAGGCGG -> GAGGAGGCGGA
GAGGAGGCGGA -> AGGAGGCGGAC
AGGAGGCGGAC -> GGAGGCGGACA
GGAGGCGGACA -> GAGGCGGACAC
GAGGCGGACAC -> AGGCGGACACC
AGGCGGACACC -> GGCGGACACCG
GGCGGACACCG -> GCGGACACCGG
GCGGACACCGG -> CGGACACCGGG
CGGACACCGGG -> GGACACCGGGA
GGACACCGGGA -> GACACCGGGAT
GACACCGGGAT -> ACACCGGGATT
ACACCGGGATT -> CACCGGGATTC
CACCGGGATTC -> ACCGGGATTCA
ACCGGGATTCA -> CCGGGATTCAG
CCGGGATTCAG -> CGGGATTCAGA
CGGGATTCAGA -> GGGATTCAGAT
GGGATTCAGAT -> GGATTCAGATA
GGATTCAGATA -> GATTCAGATAC
GATTCAGATAC -> ATTCAGATACA
ATTCAGATACA -> TTCAGATACAC
TTCAGATACAC -> TCAGATACACT
TCAGATACACT -> CAGATACACTA
CAGATACACTA -> AGATACACTAT
AGATACACTAT -> GATACACTATC
GATACACTATC -> ATACACTATCA
ATACACTATCA -> TACACTATCAG
TACACTATCAG -> ACACTATCAGG
ACACTATCAGG -> CACTATCAGGC
CACTATCAGGC -> ACTATCAGGCC
ACTATCAGGCC -> CTATCAGGCCC
CTATCAGGCCC -> TATCAGGCCCA
TATCAGGCCCA -> ATCAGGCCCAT
ATCAGGCCCAT -> TCAGGCCCATT
TCAGGCCCATT -> CAGGCCCATTC
CAGGCCCATTC -> AGGCCCATTCA
AGGCCCATTCA -> GGCCCATTCAG
GGCCCATTCAG -> GCCCATTCAGT
GCCCATTCAGT -> CCCATTCAGTA
CCCATTCAGTA -> CCATTCAGTAT
CCATTCAGTAT -> CATTCAGTATA
CATTCAGTATA -> ATTCAGTATAT
ATTCAGTATAT -> TTCAGTATATT
TTCAGTATATT -> TCAGTATATTG
TCAGTATATTG -> CAGTATATTGG
CAGTATATTGG -> AGTATATTGGC
AGTATATTGGC -> GTATATTGGCA
GTATATTGGCA -> TATATTGGCAA
TATATTGGCAA -> ATATTGGCAAT
ATATTGGCAAT -> TATTGGCAATA
TATTGGCAATA -> ATTGGCAATAA
ATTGGCAATAA -> TTGGCAATAAC
TTGGCAATAAC -> TGGCAATAACA
TGGCAATAACA -> GGCAATAACAT
GGCAATAACAT -> GCAATAACATG
GCAATAACATG -> CAATAACATGA
CAATAACATGA -> AATAACATGAT
AATAACATGAT -> ATAACATGATA
ATAACATGATA -> TAACATGATAA
TAACATGATAA -> AACATGATAAT
AACATGATAAT -> ACATGATAATA
ACATGATAATA -> CATGATAATAA
CATGATAATAA -> ATGATAATAAG
ATGATAATAAG -> TGATAATAAGA
TGATAATAAGA -> GATAATAAGAG
GATAATAAGAG -> ATAATAAGAGA
ATAATAAGAGA -> TAATAAGAGAG
TAATAAGAGAG -> AATAAGAGAGG
AATAAGAGAGG -> ATAAGAGAGGA
ATAAGAGAGGA -> TAAGAGAGGAC
TAAGAGAGGAC -> AAGAGAGGACC
AAGAGAGGACC -> AGAGAGGACCG
AGAGAGGACCG -> GAGAGGACCGT
GAGAGGACCGT -> AGAGGACCGTT
AGAGGACCGTT -> GAGGACCGTTG
GAGGACCGTTG -> AGGACCGTTGA
AGGACCGTTGA -> GGACCGTTGAG
GGACCGTTGAG -> GACCGTTGAGA
GACCGTTGAGA -> ACCGTTGAGAC
ACCGTTGAGAC -> CCGTTGAGACT
CCGTTGAGACT -> CGTTGAGACTG
CGTTGAGACTG -> GTTGAGACTGT
GTTGAGACTGT -> TTGAGACTGTG
TTGAGACTGTG -> TGAGACTGTGT
TGAGACTGTGT -> GAGACTGTGTT
GAGACTGTGTT -> AGACTGTGTTC
AGACTGTGTTC -> GACTGTGTTCG
GACTGTGTTCG -> ACTGTGTTCGC
ACTGTGTTCGC -> CTGTGTTCGCA
CTGTGTTCGCA -> TGTGTTCGCAC
TGTGTTCGCAC -> GTGTTCGCACC
GTGTTCGCACC -> TGTTCGCACCC
TGTTCGCACCC -> GTTCGCACCCA
GTTCGCACCCA -> TTCGCACCCAA
TTCGCACCCAA -> TCGCACCCAAA
TCGCACCCAAA -> CGCACCCAAAC
CGCACCCAAAC -> GCACCCAAACA
GCACCCAAACA -> CACCCAAACAT
CACCCAAACAT -> ACCCAAACATA
ACCCAAACATA -> CCCAAACATAG
CCCAAACATAG -> CCAAACATAGC
CCAAACATAGC -> CAAACATAGCG
CAAACATAGCG -> AAACATAGCGA
AAACATAGCGA -> AACATAGCGAA
AACATAGCGAA -> ACATAGCGAAG
ACATAGCGAAG -> CATAGCGAAGC
CATAGCGAAGC -> ATAGCGAAGCA
ATAGCGAAGCA -> TAGCGAAGCAC
TAGCGAAGCAC -> AGCGAAGCACT
AGCGAAGCACT -> GCGAAGCACTT
GCGAAGCACTT -> CGAAGCACTTG
CGAAGCACTTG -> GAAGCACTTGT
GAAGCACTTGT -> AAGCACTTGTA
AAGCACTTGTA -> AGCACTTGTAA
AGCACTTGTAA -> GCACTTGTAAA
GCACTTGTAAA -> CACTTGTAAAT
CACTTGTAAAT -> ACTTGTAAATA
ACTTGTAAATA -> CTTGTAAATAA
CTTGTAAATAA -> TTGTAAATAAA
TTGTAAATAAA -> TGTAAATAAAA
TGTAAATAAAA -> GTAAATAAAAC
GTAAATAAAAC -> TAAATAAAACG
TAAATAAAACG -> AAATAAAACGG
AAATAAAACGG -> AATAAAACGGT
AATAAAACGGT -> ATAAAACGGTA
ATAAAACGGTA -> TAAAACGGTAT
TAAAACGGTAT -> AAAACGGTATT
AAAACGGTATT -> AAACGGTATTG
AAACGGTATTG -> AACGGTATTGG
AACGGTATTGG -> ACGGTATTGGA
ACGGTATTGGA -> CGGTATTGGAG
CGGTATTGGAG -> GGTATTGGAGC
GGTATTGGAGC -> GTATTGGAGCG
GTATTGGAGCG -> TATTGGAGCGG
TATTGGAGCGG -> ATTGGAGCGGG
ATTGGAGCGGG -> TTGGAGCGGGG
TTGGAGCGGGG -> TGGAGCGGGGT
TGGAGCGGGGT -> GGAGCGGGGTG
GGAGCGGGGTG -> GAGCGGGGTGT
GAGCGGGGTGT -> AGCGGGGTGTC
AGCGGGGTGTC -> GCGGGGTGTCG
GCGGGGTGTCG -> CGGGGTGTCGA
CGGGGTGTCGA -> GGGGTGTCGAT
GGGGTGTCGAT -> GGGTGTCGATC
GGGTGTCGATC -> GGTGTCGATCT
GGTGTCGATCT -> GTGTCGATCTC
GTGTCGATCTC -> TGTCGATCTCC
TGTCGATCTCC -> GTCGATCTCCT
GTCGATCTCCT -> TCGATCTCCTA
TCGATCTCCTA -> CGATCTCCTAG
CGATCTCCTAG -> GATCTCCTAGG
GATCTCCTAGG -> ATCTCCTAGGA
ATCTCCTAGGA -> TCTCCTAGGAA
TCTCCTAGGAA -> CTCCTAGGAAT
CTCCTAGGAAT -> TCCTAGGAATC
TCCTAGGAATC -> CCTAGGAATCT
CCTAGGAATCT -> CTAGGAATCTG
CTAGGAATCTG -> TAGGAATCTGC
TAGGAATCTGC -> AGGAATCTGCG
AGGAATCTGCG -> GGAATCTGCGC
GGAATCTGCGC -> GAATCTGCGCT
GAATCTGCGCT -> AATCTGCGCTG
AATCTGCGCTG -> ATCTGCGCTGA
ATCTGCGCTGA -> TCTGCGCTGAC
TCTGCGCTGAC -> CTGCGCTGACA
CTGCGCTGACA -> TGCGCTGACAG
TGCGCTGACAG -> GCGCTGACAGA
GCGCTGACAGA -> CGCTGACAGAT
CGCTGACAGAT -> GCTGACAGATT
GCTGACAGATT -> CTGACAGATTG
CTGACAGATTG -> TGACAGATTGT
TGACAGATTGT -> GACAGATTGTT
GACAGATTGTT -> ACAGATTGTTC
ACAGATTGTTC -> CAGATTGTTCT
CAGATTGTTCT -> AGATTGTTCTT
AGATTGTTCTT -> GATTGTTCTTC
GATTGTTCTTC -> ATTGTTCTTCA
ATTGTTCTTCA -> TTGTTCTTCAA
TTGTTCTTCAA -> TGTTCTTCAAT
TGTTCTTCAAT -> GTTCTTCAATG
GTTCTTCAATG -> TTCTTCAATGT
TTCTTCAATGT -> TCTTCAATGTG
TCTTCAATGTG -> CTTCAATGTGC
CTTCAATGTGC -> TTCAATGTGCC
TTCAATGTGCC -> TCAATGTGCCA
TCAATGTGCCA -> CAATGTGCCAC
CAATGTGCCAC -> AATGTGCCACA
AATGTGCCACA -> ATGTGCCACAT
ATGTGCCACAT -> TGTGCCACATA
TGTGCCACATA -> GTGCCACATAC
GTGCCACATAC -> TGCCACATACC
TGCCACATACC -> GCCACATACCA
GCCACATACCA -> CCACATACCAG
CCACATACCAG -> CACATACCAGG
CACATACCAGG -> ACATACCAGGG
ACATACCAGGG -> CATACCAGGGA
CATACCAGGGA -> ATACCAGGGAG
ATACCAGGGAG -> TACCAGGGAGT
TACCAGGGAGT -> ACCAGGGAGTT
ACCAGGGAGTT -> CCAGGGAGTTG
CCAGGGAGTTG -> CAGGGAGTTGC
CAGGGAGTTGC -> AGGGAGTTGCA
AGGGAGTTGCA -> GGGAGTTGCAA
GGGAGTTGCAA -> GGAGTTGCAAC
GGAGTTGCAAC -> GAGTTGCAACG
GAGTTGCAACG -> AGTTGCAACGC
AGTTGCAACGC -> GTTGCAACGCA
GTTGCAACGCA -> TTGCAACGCAA
TTGCAACGCAA -> TGCAACGCAAA
TGCAACGCAAA -> GCAACGCAAAT
GCAACGCAAAT -> CAACGCAAATG
CAACGCAAATG -> AACGCAAATGT
AACGCAAATGT -> ACGCAAATGTG
ACGCAAATGTG -> CGCAAATGTGT
CGCAAATGTGT -> GCAAATGTGTG
GCAAATGTGTG -> CAAATGTGTGT
CAAATGTGTGT -> AAATGTGTGTG
AAATGTGTGTG -> AATGTGTGTGA
AATGTGTGTGA -> ATGTGTGTGAC
ATGTGTGTGAC -> TGTGTGTGACA
TGTGTGTGACA -> GTGTGTGACAA
GTGTGTGACAA -> TGTGTGACAAT
TGTGTGACAAT -> GTGTGACAATG
GTGTGACAATG -> TGTGACAATGA
TGTGACAATGA -> GTGACAATGAG
GTGACAATGAG -> TGACAATGAGT
TGACAATGAGT -> GACAATGAGTA
GACAATGAGTA -> ACAATGAGTAT
ACAATGAGTAT -> CAATGAGTATG
CAATGAGTATG -> AATGAGTATGC
AATGAGTATGC -> ATGAGTATGCT
ATGAGTATGCT -> TGAGTATGCTG
TGAGTATGCTG -> GAGTATGCTGC
GAGTATGCTGC -> AGTATGCTGCG
AGTATGCTGCG -> GTATGCTGCGC
GTATGCTGCGC -> TATGCTGCGCC
TATGCTGCGCC -> ATGCTGCGCCT
ATGCTGCGCCT -> TGCTGCGCCTA
TGCTGCGCCTA -> GCTGCGCCTAG
GCTGCGCCTAG -> CTGCGCCTAGG
CTGCGCCTAGG -> TGCGCCTAGGA
TGCGCCTAGGA -> GCGCCTAGGAT
GCGCCTAGGAT -> CGCCTAGGATG
CGCCTAGGATG -> GCCTAGGATGT
GCCTAGGATGT -> CCTAGGATGTC
CCTAGGATGTC -> CTAGGATGTCA
CTAGGATGTCA -> TAGGATGTCAG
TAGGATGTCAG -> AGGATGTCAGT
AGGATGTCAGT -> GGATGTCAGTT
GGATGTCAGTT -> GATGTCAGTTG
GATGTCAGTTG -> ATGTCAGTTGT
ATGTCAGTTGT -> TGTCAGTTGTG
TGTCAGTTGTG -> GTCAGTTGTGA
GTCAGTTGTGA -> TCAGTTGTGAG
TCAGTTGTGAG -> CAGTTGTGAGT
CAGTTGTGAGT -> AGTTGTGAGTC
AGTTGTGAGTC -> GTTGTGAGTCG
GTTGTGAGTCG -> TTGTGAGTCGG
TTGTGAGTCGG -> TGTGAGTCGGC
TGTGAGTCGGC -> GTGAGTCGGCC
GTGAGTCGGCC -> TGAGTCGGCCT
TGAGTCGGCCT -> GAGTCGGCCTC
GAGTCGGCCTC -> AGTCGGCCTCA
AGTCGGCCTCA -> GTCGGCCTCAG
GTCGGCCTCAG -> TCGGCCTCAGA
TCGGCCTCAGA -> CGGCCTCAGAT
CGGCCTCAGAT -> GGCCTCAGATT
GGCCTCAGATT -> GCCTCAGATTT
GCCTCAGATTT -> CCTCAGATTTT
CCTCAGATTTT -> CTCAGATTTTT
CTCAGATTTTT -> TCAGATTTTTA
TCAGATTTTTA -> CAGATTTTTAG
CAGATTTTTAG -> AGATTTTTAGA
AGATTTTTAGA -> GATTTTTAGAT
GATTTTTAGAT -> ATTTTTAGATA
ATTTTTAGATA -> TTTTTAGATAA
TTTTTAGATAA -> TTTTAGATAAC
TTTTAGATAAC -> TTTAGATAACG
TTTAGATAACG -> TTAGATAACGC
TTAGATAACGC -> TAGATAACGCT
TAGATAACGCT -> AGATAACGCTT
AGATAACGCTT -> GATAACGCTTA
GATAACGCTTA -> ATAACGCTTAA
ATAACGCTTAA -> TAACGCTTAAG
TAACGCTTAAG -> AACGCTTAAGA
AACGCTTAAGA -> ACGCTTAAGAA
ACGCTTAAGAA -> CGCTTAAGAAG
CGCTTAAGAAG -> GCTTAAGAAGT
GCTTAAGAAGT -> CTTAAGAAGTT
CTTAAGAAGTT -> TTAAGAAGTTA
TTAAGAAGTTA -> TAAGAAGTTAC
TAAGAAGTTAC -> AAGAAGTTACC
AAGAAGTTACC -> AGAAGTTACCC
AGAAGTTACCC -> GAAGTTACCCT
GAAGTTACCCT -> AAGTTACCCTA
AAGTTACCCTA -> AGTTACCCTAA
AGTTACCCTAA -> GTTACCCTAAG
GTTACCCTAAG -> TTACCCTAAGG
TTACCCTAAGG -> TACCCTAAGGG
TACCCTAAGGG -> ACCCTAAGGGT
ACCCTAAGGGT -> CCCTAAGGGTC
CCCTAAGGGTC -> CCTAAGGGTCT
CCTAAGGGTCT -> CTAAGGGTCTA
CTAAGGGTCTA -> TAAGGGTCTAG
TAAGGGTCTAG -> AAGGGTCTAGT
AAGGGTCTAGT -> AGGGTCTAGTA
AGGGTCTAGTA -> GGGTCTAGTAG
GGGTCTAGTAG -> GGTCTAGTAGT
GGTCTAGTAGT -> GTCTAGTAGTG
GTCTAGTAGTG -> TCTAGTAGTGC
TCTAGTAGTGC -> CTAGTAGTGCC
CTAGTAGTGCC -> TAGTAGTGCCT
TAGTAGTGCCT -> AGTAGTGCCTA
AGTAGTGCCTA -> GTAGTGCCTAC
GTAGTGCCTAC -> TAGTGCCTACC
TAGTGCCTACC -> AGTGCCTACCT
AGTGCCTACCT -> GTGCCTACCTG
GTGCCTACCTG -> TGCCTACCTGT
TGCCTACCTGT -> GCCTACCTGTC
GCCTACCTGTC -> CCTACCTGTCT
CCTACCTGTCT -> CTACCTGTCTG
CTACCTGTCTG -> TACCTGTCTGA
TACCTGTCTGA -> ACCTGTCTGAT
ACCTGTCTGAT -> CCTGTCTGATG
CCTGTCTGATG -> CTGTCTGATGC
CTGTCTGATGC -> TGTCTGATGCC
TGTCTGATGCC -> GTCTGATGCCT
GTCTGATGCCT -> TCTGATGCCTG
TCTGATGCCTG -> CTGATGCCTGT
CTGATGCCTGT -> TGATGCCTGTC
TGATGCCTGTC -> GATGCCTGTCG
GATGCCTGTCG -> ATGCCTGTCGT
ATGCCTGTCGT -> TGCCTGTCGTA
TGCCTGTCGTA -> GCCTGTCGTAT
GCCTGTCGTAT -> CCTGTCGTATG
CCTGTCGTATG -> CTGTCGTATGG
CTGTCGTATGG -> TGTCGTATGGC
TGTCGTATGGC -> GTCGTATGGCA
GTCGTATGGCA -> TCGTATGGCAA
TCGTATGGCAA -> CGTATGGCAAG
CGTATGGCAAG -> GTATGGCAAGG
GTATGGCAAGG -> TATGGCAAGGG
TATGGCAAGGG -> ATGGCAAGGGC
ATGGCAAGGGC -> TGGCAAGGGCC
TGGCAAGGGCC -> GGCAAGGGCCA
GGCAAGGGCCA -> GCAAGGGCCAG
GCAAGGGCCAG -> CAAGGGCCAGA
CAAGGGCCAGA -> AAGGGCCAGAG
AAGGGCCAGAG -> AGGGCCAGAGG
AGGGCCAGAGG -> GGGCCAGAGGC
GGGCCAGAGGC -> GGCCAGAGGCG
GGCCAGAGGCG -> GCCAGAGGCGA
GCCAGAGGCGA -> CCAGAGGCGAT
CCAGAGGCGAT -> CAGAGGCGATC
CAGAGGCGATC -> AGAGGCGATCA
AGAGGCGATCA -> GAGGCGATCAT
GAGGCGATCAT -> AGGCGATCATG
AGGCGATCATG -> GGCGATCATGT
GGCGATCATGT -> GCGATCATGTC
GCGATCATGTC -> CGATCATGTCC
CGATCATGTCC -> GATCATGTCCG
GATCATGTCCG -> ATCATGTCCGG
ATCATGTCCGG -> TCATGTCCGGA
TCATGTCCGGA -> CATGTCCGGAA
CATGTCCGGAA -> ATGTCCGGAAC
ATGTCCGGAAC -> TGTCCGGAACC
TGTCCGGAACC -> GTCCGGAACCG
GTCCGGAACCG -> TCCGGAACCGT
TCCGGAACCGT -> CCGGAACCGTA
CCGGAACCGTA -> CGGAACCGTAA
CGGAACCGTAA -> GGAACCGTAAC
GGAACCGTAAC -> GAACCGTAACT
GAACCGTAACT -> AACCGTAACTA
AACCGTAACTA -> ACCGTAACTAC
ACCGTAACTAC -> CCGTAACTACG
CCGTAACTACG -> CGTAACTACGA
CGTAACTACGA -> GTAACTACGAT
GTAACTACGAT -> TAACTACGATG
TAACTACGATG -> AACTACGATGA
AACTACGATGA -> ACTACGATGAT
ACTACGATGAT -> CTACGATGATT
CTACGATGATT -> TACGATGATTC
TACGATGATTC -> ACGATGATTCT
ACGATGATTCT -> CGATGATTCTA
CGATGATTCTA -> GATGATTCTAT
GATGATTCTAT -> ATGATTCTATG
ATGATTCTATG -> TGATTCTATGC
TGATTCTATGC -> GATTCTATGCC
GATTCTATGCC -> ATTCTATGCCC
ATTCTATGCCC -> TTCTATGCCCC
TTCTATGCCCC -> TCTATGCCCCG
TCTATGCCCCG -> CTATGCCCCGT
CTATGCCCCGT -> TATGCCCCGTA
TATGCCCCGTA -> ATGCCCCGTAT
ATGCCCCGTAT -> TGCCCCGTATA
TGCCCCGTATA -> GCCCCGTATAT
GCCCCGTATAT -> CCCCGTATATG
CCCCGTATATG -> CCCGTATATGA
CCCGTATATGA -> CCGTATATGAT
CCGTATATGAT -> CGTATATGATA
CGTATATGATA -> GTATATGATAA
GTATATGATAA -> TATATGATAAG
TATATGATAAG -> ATATGATAAGT
ATATGATAAGT -> TATGATAAGTC
TATGATAAGTC -> ATGATAAGTCG
ATGATAAGTCG -> TGATAAGTCGC
TGATAAGTCGC -> GATAAGTCGCG
GATAAGTCGCG -> ATAAGTCGCGT
ATAAGTCGCGT -> TAAGTCGCGTA
TAAGTCGCGTA -> AAGTCGCGTAA
AAGTCGCGTAA -> AGTCGCGTAAC
AGTCGCGTAAC -> GTCGCGTAACG
GTCGCGTAACG -> TCGCGTAACGG
TCGCGTAACGG -> CGCGTAACGGC
CGCGTAACGGC -> GCGTAACGGCA
GCGTAACGGCA -> CGTAACGGCAT
CGTAACGGCAT -> GTAACGGCATA
GTAACGGCATA -> TAACGGCATAA
TAACGGCATAA -> AACGGCATAAG
AACGGCATAAG -> ACGGCATAAGT
ACGGCATAAGT -> CGGCATAAGTA
GGCATAAGTAT -> GCATAAGTATA
GCATAAGTATA -> CATAAGTATAG
CATAAGTATAG -> ATAAGTATAGA
ATAAGTATAGA -> TAAGTATAGAA
TAAGTATAGAA -> AAGTATAGAAC
AAGTATAGAAC -> AGTATAGAACG
AGTATAGAACG -> GTATAGAACGG
GTATAGAACGG -> TATAGAACGGA
TATAGAACGGA -> ATAGAACGGAC
ATAGAACGGAC -> TAGAACGGACG
TAGAACGGACG -> AGAACGGACGT
AGAACGGACGT -> GAACGGACGTC
GAACGGACGTC -> AACGGACGTCA
AACGGACGTCA -> ACGGACGTCAC
ACGGACGTCAC -> CGGACGTCACG
CGGACGTCACG -> GGACGTCACGC
GGACGTCACGC -> GACGTCACGCC
GACGTCACGCC -> ACGTCACGCCC
ACGTCACGCCC -> CGTCACGCCCG
CGTCACGCCCG -> GTCACGCCCGC
GTCACGCCCGC -> TCACGCCCGCG
TCACGCCCGCG -> CACGCCCGCGT
CACGCCCGCGT -> ACGCCCGCGTC
ACGCCCGCGTC -> CGCCCGCGTCG
CGCCCGCGTCG -> GCCCGCGTCGT
GCCCGCGTCGT -> CCCGCGTCGTG
CCCGCGTCGTG -> CCGCGTCGTGC
CCGCGTCGTGC -> CGCGTCGTGCA
CGCGTCGTGCA -> GCGTCGTGCAA
GCGTCGTGCAA -> CGTCGTGCAAT
CGTCGTGCAAT -> GTCGTGCAATT
GTCGTGCAATT -> TCGTGCAATTT
TCGTGCAATTT -> CGTGCAATTTC
CGTGCAATTTC -> GTGCAATTTCC
GTGCAATTTCC -> TGCAATTTCCT
TGCAATTTCCT -> GCAATTTCCTC
GCAATTTCCTC -> CAATTTCCTCT
CAATTTCCTCT -> AATTTCCTCTA
AATTTCCTCTA -> ATTTCCTCTAC
ATTTCCTCTAC -> TTTCCTCTACA
TTTCCTCTACA -> TTCCTCTACAG
TTCCTCTACAG -> TCCTCTACAGG
TCCTCTACAGG -> CCTCTACAGGA
CCTCTACAGGA -> CTCTACAGGAA
CTCTACAGGAA -> TCTACAGGAAT
TCTACAGGAAT -> CTACAGGAATT
CTACAGGAATT -> TACAGGAATTG
TACAGGAATTG -> ACAGGAATTGG
ACAGGAATTGG -> CAGGAATTGGT
CAGGAATTGGT -> AGGAATTGGTA
AGGAATTGGTA -> GGAATTGGTAG
GGAATTGGTAG -> GAATTGGTAGG
GAATTGGTAGG -> AATTGGTAGGG
AATTGGTAGGG -> ATTGGTAGGGT
ATTGGTAGGGT -> TTGGTAGGGTA
TTGGTAGGGTA -> TGGTAGGGTAC
TGGTAGGGTAC -> GGTAGGGTACC
GGTAGGGTACC -> GTAGGGTACCA
GTAGGGTACCA -> TAGGGTACCAG
TAGGGTACCAG -> AGGGTACCAGA
AGGGTACCAGA -> GGGTACCAGAT
GGGTACCAGAT -> GGTACCAGATT
GGTACCAGATT -> GTACCAGATTC
GTACCAGATTC -> TACCAGATTCG
TACCAGATTCG -> ACCAGATTCGG
ACCAGATTCGG -> CCAGATTCGGA
CCAGATTCGGA -> CAGATTCGGAA
CAGATTCGGAA -> AGATTCGGAAG
AGATTCGGAAG -> GATTCGGAAGT
GATTCGGAAGT -> ATTCGGAAGTT
ATTCGGAAGTT -> TTCGGAAGTTG
TTCGGAAGTTG -> TCGGAAGTTGA
TCGGAAGTTGA -> CGGAAGTTGAC
CGGAAGTTGAC -> GGAAGTTGACG
GGAAGTTGACG -> GAAGTTGACGG
GAAGTTGACGG -> AAGTTGACGGG
AAGTTGACGGG -> AGTTGACGGGA
AGTTGACGGGA -> GTTGACGGGAA
GTTGACGGGAA -> TTGACGGGAAC
TTGACGGGAAC -> TGACGGGAACC
TGACGGGAACC -> GACGGGAACCA
GACGGGAACCA -> ACGGGAACCAG
ACGGGAACCAG -> CGGGAACCAGC
CGGGAACCAGC -> GGGAACCAGCG
GGGAACCAGCG -> GGAACCAGCGA
GGAACCAGCGA -> GAACCAGCGAC
GAACCAGCGAC -> AACCAGCGACT
AACCAGCGACT -> ACCAGCGACTG
ACCAGCGACTG -> CCAGCGACTGT
CCAGCGACTGT -> CAGCGACTGTC
CAGCGACTGTC -> AGCGACTGTCG
AGCGACTGTCG -> GCGACTGTCGA
GCGACTGTCGA -> CGACTGTCGAG
CGACTGTCGAG -> GACTGTCGAGA
GACTGTCGAGA -> ACTGTCGAGAT
ACTGTCGAGAT -> CTGTCGAGATC
CTGTCGAGATC -> TGTCGAGATCT
TGTCGAGATCT -> GTCGAGATCTC
GTCGAGATCTC -> TCGAGATCTCC
TCGAGATCTCC -> CGAGATCTCCT
CGAGATCTCCT -> GAGATCTCCTC
GAGATCTCCTC -> AGATCTCCTCG
AGATCTCCTCG -> GATCTCCTCGA
GATCTCCTCGA -> ATCTCCTCGAG
ATCTCCTCGAG -> TCTCCTCGAGA
TCTCCTCGAGA -> CTCCTCGAGAG
CTCCTCGAGAG -> TCCTCGAGAGA
TCCTCGAGAGA -> CCTCGAGAGAC
CCTCGAGAGAC -> CTCGAGAGACC
CTCGAGAGACC -> TCGAGAGACCT
TCGAGAGACCT -> CGAGAGACCTT
CGAGAGACCTT -> GAGAGACCTTG
GAGAGACCTTG -> AGAGACCTTGA
AGAGACCTTGA -> GAGACCTTGAA
GAGACCTTGAA -> AGACCTTGAAT
AGACCTTGAAT -> GACCTTGAATC
GACCTTGAATC -> ACCTTGAATCG
ACCTTGAATCG -> CCTTGAATCGC
CCTTGAATCGC -> CTTGAATCGCC
CTTGAATCGCC -> TTGAATCGCCT
TTGAATCGCCT -> TGAATCGCCTA
TGAATCGCCTA -> GAATCGCCTAT
GAATCGCCTAT -> AATCGCCTATG
AATCGCCTATG -> ATCGCCTATGG
ATCGCCTATGG -> TCGCCTATGGA
TCGCCTATGGA -> CGCCTATGGAG
CGCCTATGGAG -> GCCTATGGAGT
GCCTATGGAGT -> CCTATGGAGTC
CCTATGGAGTC -> CTATGGAGTCT
CTATGGAGTCT -> TATGGAGTCTG
TATGGAGTCTG -> ATGGAGTCTGA
ATGGAGTCTGA -> TGGAGTCTGAA
TGGAGTCTGAA -> GGAGTCTGAAG
GGAGTCTGAAG -> GAGTCTGAAGG
GAGTCTGAAGG -> AGTCTGAAGGA
AGTCTGAAGGA -> GTCTGAAGGAC
GTCTGAAGGAC -> TCTGAAGGACT
TCTGAAGGACT -> CTGAAGGACTA
CTGAAGGACTA -> TGAAGGACTAG
TGAAGGACTAG -> GAAGGACTAGG
GAAGGACTAGG -> AAGGACTAGGC
AAGGACTAGGC -> AGGACTAGGCC
AGGACTAGGCC -> GGACTAGGCCG
GGACTAGGCCG -> GACTAGGCCGA
GACTAGGCCGA -> ACTAGGCCGAC
ACTAGGCCGAC -> CTAGGCCGACC
CTAGGCCGACC -> TAGGCCGACCA
TAGGCCGACCA -> AGGCCGACCAG
AGGCCGACCAG -> GGCCGACCAGT
GGCCGACCAGT -> GCCGACCAGTA
GCCGACCAGTA -> CCGACCAGTAC
CCGACCAGTAC -> CGACCAGTACG
CGACCAGTACG -> GACCAGTACGT
GACCAGTACGT -> ACCAGTACGTC
ACCAGTACGTC -> CCAGTACGTCG
CCAGTACGTCG -> CAGTACGTCGT
CAGTACGTCGT -> AGTACGTCGTA
AGTACGTCGTA -> GTACGTCGTAT
GTACGTCGTAT -> TACGTCGTATC
