30 100
TTGTTTCTATCCTTGTCGATAAGCATCACG|TGCAAGTTAACCCCCTGCTACCACCCCAAT
TTCGGCTCAAAAAAGCCACTCGTCCCTAAT|TTGTGCCAGTACTTGGCATTTTGCACTGGT
TTAACGAACGGCCGGCAAGTTAACCCCCTG|ATTTGCTACAAGTTAACCCCCTGCTACCAC
ACTGGAAACACCGCTTGAGAGCTGAGAGTC|CAATTAGGGGAAATCCAGTGACTCACAAGT
ACCCCAATCACGGGTGACAAGTTAACCCCC|GATGATACATCGAGACCCTCTACCGGCAGT
AATGCAAGTTAACCCCCTGCTACCACCCCA|CTGCTACCACCCCAATCATTCGCATATCTG
GTCATGCGTCTCGAAATGGGCAGACAGCGA|CCCACGGAGGCGTAGGACAGATTGCCGTTA
TCCTATGTGGTTTGTTTCTATCCTTGTCGA|TCACTTTGAAATGCAAGTTAACCCCCTGCT
GATGTACCCGCTTCTGCGCCTACAATGAAC|CAAGTTAACCCCCTGCTACCACCCCAATCA
ACAGAGACTTGCCATCAACCTACTATTCCT|TCGGTAAGTACTGATTGTGAACCCCAGAGT
CGGGAGGGCGACAAGTTAACCCCCTGCTAC|CGCCCCTTCCTATGTGGTTTGTTTCTATCC
TTTAGTCTCACATTCTGAATGAGTCATTAC|GATGTTCGGCTCAAAAAAGCCACTCGTCCC
GTAATGTACTTGCTCAAGTTAACCCCCTGC|AGTGGCCCAAAACTAATCTGTGGCCCACGT
AGTTAACCCCCTGCTACCACCCCAATCAGG|TCTGCTACACAAGTTAACCCCCTGCTACCA
TAACCCCCTGCTACCACCCCAATCACCAAT|GGGCAGACAGCGACCGCATGGGCTCGATGT
ATTAGAGTGAATAGCGCCCCTTCCTATGTG|ACACCGCTTGAGAGCTGAGAGTCACTTTGA
AGCTGAGAGTCACTTTGAAATGCAAGTTAA|GACTCACAAGTTAACCCCCTGCTACCACCC
GGCGTAGGACAGATTGCCGTTAACGAACGG|ACGGCAATGCCACCGTCTGATTTGCTACAA
AGCAGAAATAGACTGAACAGCGTGGCCGTC|AACCCCCTGCTACCACCCCAATCACGGGTG
TACCACCCCAATCAAACTGGAAACACCGCT|TGCTACCACCCCAATCAATTAGGGGAAATC
CTGCTACCACCCCAATCACGCTCGGGCTTC|CTGCTACCACCCAAGTTAACCCCCTGCTAC
TCACGCTCGGGCTTCGCTAAACTTTCAAGG|TTAACCCCCTGCTACCACCCCAATCACCAA
GCCATCACCCCGTATCGGACCTCGGAGTGC|TAGTCTCACATTCTGAATGAGTCATTACGG
CCTGCTACCACCCCAATCACGCTCGGGCTT|CCTGCTACCACCCAAGTTAACCCCCTGCTA
ACCTCGTTAATCTTTGATTAGAGTGAATAG|CCCAATCAAACTGGAAACACCGCTTGAGAG
TACCACCCCAATCACCAATCATTTCGTACT|GACCGCATGGGCTCGATGTACCCGCTTCTG
ACCCAAGTTAACCCCCTGCTACCACCCCAA|CTCGAAATGGGCAGACAGCGACCGCATGGG
ACTTGCTCAAGTTAACCCCCTGCTACCACC|CAAAACTAATCTGTGGCCCACGTGAACGAT
TCAAAAAAGCCACTCGTCCCTAATATCGCC|CAGTACTTGGCATTTTGCACTGGTGCAGGT
AGTGACTCACAAGTTAACCCCCTGCTACCA|AAGCAAGTTAACCCCCTGCTACCACCCCCA
CTTGAGAGCTGAGAGTCACTTTGAAATGCA|TCCAGTGACTCACAAGTTAACCCCCTGCTA
CCCAATCAAACTGGAAACACCGCTTGAGAG|CACCCCAATCAATTAGGGGAAATCCAGTGA
CCAAGTTAACCCCCTGCTACCACCCCAATC|CGAAATGGGCAGACAGCGACCGCATGGGCT
TGACAAGTTAACCCCCTGCTACCACCCAAG|ACCCTCTACCGGCAGTCATGCGTCTCGAAA
ACCCCAATCACGGCAATGCCACCGTCTGAT|TGTCGATAAGCATCACGAGTCCAGACCTAA
ACAGATTGCCGTTAACGAACGGCCGGCAAG|GCCACCGTCTGATTTGCTACAAGTTAACCC
GGGTGACAAGTTAACCCCCTGCTACCACCC|GAGACCCTCTACCGGCAGTCATGCGTCTCG
GGGATGACAACACCAGGTGCGATGTTCGGC|ACCCCAATCATCGGACGACACTATTTGTGC
GCGAGTTGTCCGGGAGACAGAGACTTGCCA|CCCTGCTGCTGATGCTTCGGTAAGTACTGA
CCTTCCTATGTGGTTTGTTTCTATCCTTGT|GAGTCACTTTGAAATGCAAGTTAACCCCCT
TGCGCCTACAATGAACTTTACGAGATTCAC|GCTACCACCCCAATCAGTCTGCCGGAAGGG
TGCTACCACCCCAATCACCCGCTCTTCCCA|GGCGACAAGTTAACCCCCTGCTACCACCCC
TGCTACCACCCCAATCAATTAGGGGAAATC|CGGAGTGCTGCCCAGAACTTGCATATTCCG
ACCTACTATTCCTTTCCACGCGGCCGGAGT|TGAACCCCAGAGTACAAGTTAACCCCCTGC
AGACCTAAGTTCTATTTCTGCTACACAAGT|CACTTGACGCAAAACACCGCACCGCCAACA
ATCGAGACCCTCTACCGGCAGTCATGCGTC|CACCCCAATCACCCGCTCTTCCCACGGAGG
TACACAAGTTAACCCCCTGCTACCACCCCA|CCGCCAACAAGTTAACCCCCTGCTACCACC
CTGCCGGAAGGGAAGTCCCATTACCGGGAG|TTAATCTTTGATTAGAGTGAATAGCGCCCC
TACAAGTTAACCCCCTGCTACCACCCCAAT|TATTTCTGCTACACAAGTTAACCCCCTGCT
GGTGACAAGTTAACCCCCTGCTACCACCCA|AGACCCTCTACCGGCAGTCATGCGTCTCGA
GCCCAAAACTAATCTGTGGCCCACGTGAAC|TTTACGAGATTCACTCCACCAAGTTAACCC
ACCCCCTGCTACCACCCCAATCAGTCTGCC|GCTACCACCCCAATCAGGCACCTCGTTAAT
CTTCCCACGGAGGCGTAGGACAGATTGCCG|CCACCCCAATCACGGCAATGCCACCGTCTG
CCCAATCAAATCAGTACTGGACTGGTTTAG|TCACTGGGATGACAACACCAGGTGCGATGT
AATGAGTCATTACGGGTCGCTAATCTGCGA|AGCCACTCGTCCCTAATATCGCCATTCCCT
CCGTCCCAAGTTAACCCCCTGCTACCACCC|GGGTGACAAGTTAACCCCCTGCTACCACCC
TCCGGAAGCAAGTTAACCCCCTGCTACCAC|GTCCGGGAGACAGAGACTTGCCATCAACCT
CCAAGTTAACCCCCTGCTACCACCCCAATC|TATTCCTTTCCACGCGGCCGGAGTCACTGG
AAGCCACTCGTCCCTAATATCGCCATTCCC|TTGGCATTTTGCACTGGTGCAGGTGCTTGC
CCACCCCAATCAATTAGGGGAAATCCAGTG|TGCTGCCCAGAACTTGCATATTCCGGAAGC
GCTACCACCCCCAAGTTAACCCCCTGCTAC|ATCAACCTACTATTCCTTTCCACGCGGCCG
CGTCTGCTCTGGTCTCTGTAATGTACTTGC|TCGTACTTTGGGACGCGAGTGGCCCAAAAC
CTCCACCAAGTTAACCCCCTGCTACCACCC|GAAGTCCCATTACCGGGAGGGCGACAAGTT
TTTCCACGCGGCCGGAGTCACTGGGATGAC|TACAAGTTAACCCCCTGCTACCACCCCAAT
CGGAAGGGAAGTCCCATTACCGGGAGGGCG|TCTTTGATTAGAGTGAATAGCGCCCCTTCC
CACCAGGTGCGATGTTCGGCTCAAAAAAGC|TCGGACGACACTATTTGTGCCAGTACTTGG
CGTAGGACAGATTGCCGTTAACGAACGGCC|GGCAATGCCACCGTCTGATTTGCTACAAGT
ATCAGGCACCTCGTTAATCTTTGATTAGAG|CTACCACCCCAATCAAACTGGAAACACCGC
ACACCAGGTGCGATGTTCGGCTCAAAAAAG|ATCGGACGACACTATTTGTGCCAGTACTTG
AGATTCACTCCACCAAGTTAACCCCCTGCT|CGGAAGGGAAGTCCCATTACCGGGAGGGCG
TATCTGTAATACTATGTAAACTTATCAGAA|ACCACCCCAATCAAATCAGTACTGGACTGG
TAGTCTCACATTCTGAATGAGTCATTACGG|TGTTCGGCTCAAAAAAGCCACTCGTCCCTA
GGCACTTGACGCAAAACACCGCACCGCCAA|CTATGTAAACTTATCAGAACCGCCATCACC
TAATCTGTGGCCCACGTGAACGATGATACA|TTCACTCCACCAAGTTAACCCCCTGCTACC
TGACAACACCAGGTGCGATGTTCGGCTCAA|CAATCATCGGACGACACTATTTGTGCCAGT
CAATCATTTCGTACTTTGGGACGCGAGTGG|ATGTACCCGCTTCTGCGCCTACAATGAACT
CCAGGTGCGATGTTCGGCTCAAAAAAGCCA|GGACGACACTATTTGTGCCAGTACTTGGCA
AGTTCTATTTCTGCTACACAAGTTAACCCC|CGCAAAACACCGCACCGCCAACAAGTTAAC
ACCGGGAGGGCGACAAGTTAACCCCCTGCT|AGCGCCCCTTCCTATGTGGTTTGTTTCTAT
TGGTTTGTTTCTATCCTTGTCGATAAGCAT|GAAATGCAAGTTAACCCCCTGCTACCACCC
GATTTGCTACAAGTTAACCCCCTGCTACCA|TAAGTTCTATTTCTGCTACACAAGTTAACC
GTTAACCCCCTGCTACCACCCCAATCACGG|CACCCCAATCATTCGCATATCTGTAATACT
CCTGCTACCACCCCAATCAGTCTGCCGGAA|CCACCCCAATCAGGCACCTCGTTAATCTTT
GTTAACCCCCTGCTACCACCCCAATCACGG|TGGTTTGTTTCTATCCTTGTCGATAAGCAT
AGGACAGATTGCCGTTAACGAACGGCCGGC|AATGCCACCGTCTGATTTGCTACAAGTTAA
TATCCTTGTCGATAAGCATCACGAGTCCAG|TAACCCCCTGCTACCACCCCAATCACGGCA
TAGCGCCCCTTCCTATGTGGTTTGTTTCTA|GAGCTGAGAGTCACTTTGAAATGCAAGTTA
CTGGTCTCTGTAATGTACTTGCTCAAGTTA|TGGGACGCGAGTGGCCCAAAACTAATCTGT
ATTCCGGAAGCAAGTTAACCCCCTGCTACC|TTGTCCGGGAGACAGAGACTTGCCATCAAC
CTAATATCGCCATTCCCTGCTGCTGATGCT|CTGGTGCAGGTGCTTGCCAGACACTCATAA
TAGACTGAACAGCGTGGCCGTCCCAAGTTA|GCTACCACCCCAATCACGGGTGACAAGTTA
CTATGTAAACTTATCAGAACCGCCATCACC|CAAATCAGTACTGGACTGGTTTAGTCTCAC
ATAAGCATCACGAGTCCAGACCTAAGTTCT|TACCACCCCAATCACGGCACTTGACGCAAA
ATCACGAGTCCAGACCTAAGTTCTATTTCT|CCCAATCACGGCACTTGACGCAAAACACCG
ACCACCCCAATCACGGCAATGCCACCGTCT|CCTTGTCGATAAGCATCACGAGTCCAGACC
GCCATCAACCTACTATTCCTTTCCACGCGG|CTGATTGTGAACCCCAGAGTACAAGTTAAC
TACCACCCCAATCAATTAGGGGAAATCCAG|AGTGCTGCCCAGAACTTGCATATTCCGGAA
TTGAGAGCTGAGAGTCACTTTGAAATGCAA|CCAGTGACTCACAAGTTAACCCCCTGCTAC
ACTTTGAAATGCAAGTTAACCCCCTGCTAC|TAACCCCCTGCTACCACCCCAATCATTCGC
CCCCCTGCTACCACCCCAATCACGGCACTT|CAATCATTCGCATATCTGTAATACTATGTA
AGGGCGACAAGTTAACCCCCTGCTACCACC|CCTTCCTATGTGGTTTGTTTCTATCCTTGT
GAAATGGGCAGACAGCGACCGCATGGGCTC|TAGGACAGATTGCCGTTAACGAACGGCCGG
CGATAAGCATCACGAGTCCAGACCTAAGTT|GCTACCACCCCAATCACGGCACTTGACGCA
TCGCTAAACTTTCAAGGCTGAACGTCTGCT|ACCACCCCAATCACCAATCATTTCGTACTT
GTCCGGGAGACAGAGACTTGCCATCAACCT|GCTGATGCTTCGGTAAGTACTGATTGTGAA
TGAGAGTCACTTTGAAATGCAAGTTAACCC|TCACAAGTTAACCCCCTGCTACCACCCCAA
CACGCGGCCGGAGTCACTGGGATGACAACA|AGTTAACCCCCTGCTACCACCCCAATCATC
GGGGAAATCCAGTGACTCACAAGTTAACCC|CATATTCCGGAAGCAAGTTAACCCCCTGCT
TAACCCCCTGCTACCACCCCAATCAGGCAC|GCTACACAAGTTAACCCCCTGCTACCACCC
AGTTAACCCCCTGCTACCACCCCAATCACG|AGTTAACCCCCTGCTACCACCCAAGTTAAC
AGAAATAGACTGAACAGCGTGGCCGTCCCA|CCCCTGCTACCACCCCAATCACGGGTGACA
GCTTCGCTAAACTTTCAAGGCTGAACGTCT|GCTACCACCCCAATCACCAATCATTTCGTA
CAGGTGCGATGTTCGGCTCAAAAAAGCCAC|GACGACACTATTTGTGCCAGTACTTGGCAT
TACTTTGGGACGCGAGTGGCCCAAAACTAA|TCTGCGCCTACAATGAACTTTACGAGATTC
CCCTGCTACCACCCCAATCACGGGTGACAA|CCACGTGAACGATGATACATCGAGACCCTC
GAACCGCCATCACCCCGTATCGGACCTCGG|TGGTTTAGTCTCACATTCTGAATGAGTCAT
CCACCCCAATCAAACTGGAAACACCGCTTG|CTACCACCCCAATCAATTAGGGGAAATCCA
AGTTAACCCCCTGCTACCACCCCAATCATT|CCCCCTGCTACCACCCCCAAGTTAACCCCC
GTCACTTTGAAATGCAAGTTAACCCCCTGC|AGTTAACCCCCTGCTACCACCCCAATCATT
AGCGTGGCCGTCCCAAGTTAACCCCCTGCT|CAATCACGGGTGACAAGTTAACCCCCTGCT
GATGATACATCGAGACCCTCTACCGGCAGT|CCTGCTACCACCCCAATCACCCGCTCTTCC
GCCTACAATGAACTTTACGAGATTCACTCC|ACCACCCCAATCAGTCTGCCGGAAGGGAAG
GCACCTCGTTAATCTTTGATTAGAGTGAAT|ACCCCAATCAAACTGGAAACACCGCTTGAG
TGTAAACTTATCAGAACCGCCATCACCCCG|ATCAGTACTGGACTGGTTTAGTCTCACATT
ATTACGGGTCGCTAATCTGCGAGTTGTCCG|GTCCCTAATATCGCCATTCCCTGCTGCTGA
AACCCCCTGCTACCACCCCAATCACGCTCG|AACCCCCTGCTACCACCCAAGTTAACCCCC
TCGATAAGCATCACGAGTCCAGACCTAAGT|TGCTACCACCCCAATCACGGCACTTGACGC
TCCAGACCTAAGTTCTATTTCTGCTACACA|CGGCACTTGACGCAAAACACCGCACCGCCA
CTGCGCCTACAATGAACTTTACGAGATTCA|TGCTACCACCCCAATCAGTCTGCCGGAAGG
CTGCTACCACCCCCAAGTTAACCCCCTGCT|CCATCAACCTACTATTCCTTTCCACGCGGC
ATTCCTTTCCACGCGGCCGGAGTCACTGGG|CAGAGTACAAGTTAACCCCCTGCTACCACC
GACAGCGACCGCATGGGCTCGATGTACCCG|TGCCGTTAACGAACGGCCGGCAAGTTAACC
GCAAGTTAACCCCCTGCTACCACCCCCAAG|AGACAGAGACTTGCCATCAACCTACTATTC
TGCTACCACCCCAATCACCAATCATTTCGT|AGCGACCGCATGGGCTCGATGTACCCGCTT
CCACCCAAGTTAACCCCCTGCTACCACCCC|GTCTCGAAATGGGCAGACAGCGACCGCATG
CACAAGTTAACCCCCTGCTACCACCCCAAT|TTAACCCCCTGCTACCACCCCCAAGTTAAC
ACGGGTGACAAGTTAACCCCCTGCTACCAC|TCGAGACCCTCTACCGGCAGTCATGCGTCT
CTCGATGTACCCGCTTCTGCGCCTACAATG|CGGCAAGTTAACCCCCTGCTACCACCCCAA
AGTTAACCCCCTGCTACCACCCCAATCAAT|GTATCGGACCTCGGAGTGCTGCCCAGAACT
CTCGAAATGGGCAGACAGCGACCGCATGGG|GCGTAGGACAGATTGCCGTTAACGAACGGC
TCATTCGCATATCTGTAATACTATGTAAAC|CCCCCTGCTACCACCCCAATCAAATCAGTA
AACCCCCTGCTACCACCCCAATCACCCGCT|CCGGGAGGGCGACAAGTTAACCCCCTGCTA
CACCCCAATCACCCGCTCTTCCCACGGAGG|AAGTTAACCCCCTGCTACCACCCCAATCAC
AATCACCAATCATTTCGTACTTTGGGACGC|GGCTCGATGTACCCGCTTCTGCGCCTACAA
GAACGTCTGCTCTGGTCTCTGTAATGTACT|ATTTCGTACTTTGGGACGCGAGTGGCCCAA
ACCCCGTATCGGACCTCGGAGTGCTGCCCA|CACATTCTGAATGAGTCATTACGGGTCGCT
TCACCAATCATTTCGTACTTTGGGACGCGA|CTCGATGTACCCGCTTCTGCGCCTACAATG
ACCACCCCAATCAAACTGGAAACACCGCTT|GCTACCACCCCAATCAATTAGGGGAAATCC
CTACCACCCAAGTTAACCCCCTGCTACCAC|TGCGTCTCGAAATGGGCAGACAGCGACCGC
TACCACCCCAATCAAATCAGTACTGGACTG|CCGGAGTCACTGGGATGACAACACCAGGTG
GATTAGAGTGAATAGCGCCCCTTCCTATGT|AACACCGCTTGAGAGCTGAGAGTCACTTTG
CTGCTACCACCCCAATCAAACTGGAAACAC|CCCCTGCTACCACCCCAATCAATTAGGGGA
ATGGGCAGACAGCGACCGCATGGGCTCGAT|GACAGATTGCCGTTAACGAACGGCCGGCAA
AGTCCCATTACCGGGAGGGCGACAAGTTAA|AGAGTGAATAGCGCCCCTTCCTATGTGGTT
ACCACCCCAATCACGGGTGACAAGTTAACC|AACGATGATACATCGAGACCCTCTACCGGC
GATGACAACACCAGGTGCGATGTTCGGCTC|CCCAATCATCGGACGACACTATTTGTGCCA
CTTGCATATTCCGGAAGCAAGTTAACCCCC|CTGCGAGTTGTCCGGGAGACAGAGACTTGC
ACACCGCACCGCCAACAAGTTAACCCCCTG|AGAACCGCCATCACCCCGTATCGGACCTCG
GGAAACACCGCTTGAGAGCTGAGAGTCACT|TTAGGGGAAATCCAGTGACTCACAAGTTAA
ACCCCAATCATTCGCATATCTGTAATACTA|AAGTTAACCCCCTGCTACCACCCCAATCAA
GTTAACCCCCTGCTACCACCCCCAAGTTAA|AGAGACTTGCCATCAACCTACTATTCCTTT
CCTGCTACCACCCAAGTTAACCCCCTGCTA|GTCATGCGTCTCGAAATGGGCAGACAGCGA
GCTACCACCCCAATCAGGCACCTCGTTAAT|GTTAACCCCCTGCTACCACCCCAATCAAAC
GCAGTCATGCGTCTCGAAATGGGCAGACAG|CTTCCCACGGAGGCGTAGGACAGATTGCCG
GGGTCGCTAATCTGCGAGTTGTCCGGGAGA|TAATATCGCCATTCCCTGCTGCTGATGCTT
CAACAAGTTAACCCCCTGCTACCACCCCAA|ACCCCGTATCGGACCTCGGAGTGCTGCCCA
GCTCAAGTTAACCCCCTGCTACCACCCCAA|ACTAATCTGTGGCCCACGTGAACGATGATA
ATATCTGTAATACTATGTAAACTTATCAGA|TACCACCCCAATCAAATCAGTACTGGACTG
AACTTTCAAGGCTGAACGTCTGCTCTGGTC|CCAATCACCAATCATTTCGTACTTTGGGAC
CCAATCACCCGCTCTTCCCACGGAGGCGTA|TAACCCCCTGCTACCACCCCAATCACGGCA
CTACCACCCCAATCACCAATCATTTCGTAC|CGACCGCATGGGCTCGATGTACCCGCTTCT
TTATCAGAACCGCCATCACCCCGTATCGGA|CTGGACTGGTTTAGTCTCACATTCTGAATG
GCTCGATGTACCCGCTTCTGCGCCTACAAT|CCGGCAAGTTAACCCCCTGCTACCACCCCA
ATGTAAACTTATCAGAACCGCCATCACCCC|AATCAGTACTGGACTGGTTTAGTCTCACAT
TTGCTCAAGTTAACCCCCTGCTACCACCCC|AAACTAATCTGTGGCCCACGTGAACGATGA
GCTACCACCCCAATCACGGCACTTGACGCA|TTCGCATATCTGTAATACTATGTAAACTTA
GTCTCTGTAATGTACTTGCTCAAGTTAACC|GACGCGAGTGGCCCAAAACTAATCTGTGGC
TTCCGGAAGCAAGTTAACCCCCTGCTACCA|TGTCCGGGAGACAGAGACTTGCCATCAACC
CTGCCCAGAACTTGCATATTCCGGAAGCAA|GGTCGCTAATCTGCGAGTTGTCCGGGAGAC
AAGTTAACCCCCTGCTACCACCCCAATCAG|CCCCCTGCTACCACCCCAATCAGGCACCTC
GGCTGAACGTCTGCTCTGGTCTCTGTAATG|AATCATTTCGTACTTTGGGACGCGAGTGGC
CCATCACCCCGTATCGGACCTCGGAGTGCT|AGTCTCACATTCTGAATGAGTCATTACGGG
TAACCCCCTGCTACCACCCCAATCAAACTG|AGTTAACCCCCTGCTACCACCCCAATCAAT
CGCTAAACTTTCAAGGCTGAACGTCTGCTC|CCACCCCAATCACCAATCATTTCGTACTTT
CGGCAGTCATGCGTCTCGAAATGGGCAGAC|CTCTTCCCACGGAGGCGTAGGACAGATTGC
GCGCCTACAATGAACTTTACGAGATTCACT|CTACCACCCCAATCAGTCTGCCGGAAGGGA
ACCACCCCAATCACGCTCGGGCTTCGCTAA|ACCACCCAAGTTAACCCCCTGCTACCACCC
ATCGGACCTCGGAGTGCTGCCCAGAACTTG|TGAATGAGTCATTACGGGTCGCTAATCTGC
CTAATCTGTGGCCCACGTGAACGATGATAC|ATTCACTCCACCAAGTTAACCCCCTGCTAC
TTAACCCCCTGCTACCACCCCAATCAGTCT|CCTGCTACCACCCCAATCAGGCACCTCGTT
CAATTAGGGGAAATCCAGTGACTCACAAGT|AACTTGCATATTCCGGAAGCAAGTTAACCC
ACCACCCCAATCAGGCACCTCGTTAATCTT|AACCCCCTGCTACCACCCCAATCAAACTGG
TCATTTCGTACTTTGGGACGCGAGTGGCCC|TACCCGCTTCTGCGCCTACAATGAACTTTA
AATCATTTCGTACTTTGGGACGCGAGTGGC|TGTACCCGCTTCTGCGCCTACAATGAACTT
CCTTTCCACGCGGCCGGAGTCACTGGGATG|AGTACAAGTTAACCCCCTGCTACCACCCCA
AAGGGAAGTCCCATTACCGGGAGGGCGACA|TTGATTAGAGTGAATAGCGCCCCTTCCTAT
AGACAGCGACCGCATGGGCTCGATGTACCC|TTGCCGTTAACGAACGGCCGGCAAGTTAAC
CCCCGTATCGGACCTCGGAGTGCTGCCCAG|ACATTCTGAATGAGTCATTACGGGTCGCTA
TGTTTCTATCCTTGTCGATAAGCATCACGA|GCAAGTTAACCCCCTGCTACCACCCCAATC
GTTTCTATCCTTGTCGATAAGCATCACGAG|CAAGTTAACCCCCTGCTACCACCCCAATCA
TGAATAGCGCCCCTTCCTATGTGGTTTGTT|TTGAGAGCTGAGAGTCACTTTGAAATGCAA
ACCCCAATCACCAATCATTTCGTACTTTGG|GCATGGGCTCGATGTACCCGCTTCTGCGCC
CCGCTTGAGAGCTGAGAGTCACTTTGAAAT|AAATCCAGTGACTCACAAGTTAACCCCCTG
CGAGTGGCCCAAAACTAATCTGTGGCCCAC|ATGAACTTTACGAGATTCACTCCACCAAGT
AGACCCTCTACCGGCAGTCATGCGTCTCGA|CCAATCACCCGCTCTTCCCACGGAGGCGTA
ATGATACATCGAGACCCTCTACCGGCAGTC|CTGCTACCACCCCAATCACCCGCTCTTCCC
AAAACTAATCTGTGGCCCACGTGAACGATG|CGAGATTCACTCCACCAAGTTAACCCCCTG
GAGACTTGCCATCAACCTACTATTCCTTTC|GTAAGTACTGATTGTGAACCCCAGAGTACA
TCCCTAATATCGCCATTCCCTGCTGCTGAT|GCACTGGTGCAGGTGCTTGCCAGACACTCA
TCAGGCACCTCGTTAATCTTTGATTAGAGT|TACCACCCCAATCAAACTGGAAACACCGCT
CCCCCTGCTACCACCCCAATCACGGGTGAC|GCCCACGTGAACGATGATACATCGAGACCC
TAATCTGCGAGTTGTCCGGGAGACAGAGAC|GCCATTCCCTGCTGCTGATGCTTCGGTAAG
TCACAAGTTAACCCCCTGCTACCACCCCAA|GTTAACCCCCTGCTACCACCCCCAAGTTAA
CCAATCATTTCGTACTTTGGGACGCGAGTG|GATGTACCCGCTTCTGCGCCTACAATGAAC
TATGTAAACTTATCAGAACCGCCATCACCC|AAATCAGTACTGGACTGGTTTAGTCTCACA
ACCGCTTGAGAGCTGAGAGTCACTTTGAAA|GAAATCCAGTGACTCACAAGTTAACCCCCT
TGCCGGAAGGGAAGTCCCATTACCGGGAGG|TAATCTTTGATTAGAGTGAATAGCGCCCCT
CGGGTGACAAGTTAACCCCCTGCTACCACC|CGAGACCCTCTACCGGCAGTCATGCGTCTC
TCGCATATCTGTAATACTATGTAAACTTAT|CTGCTACCACCCCAATCAAATCAGTACTGG
TTCTATTTCTGCTACACAAGTTAACCCCCT|CAAAACACCGCACCGCCAACAAGTTAACCC
CCACCCCAATCAGGCACCTCGTTAATCTTT|ACCCCCTGCTACCACCCCAATCAAACTGGA
CTACCACCCCAATCACGGGTGACAAGTTAA|TGAACGATGATACATCGAGACCCTCTACCG
CTACAAGTTAACCCCCTGCTACCACCCCAA|CTATTTCTGCTACACAAGTTAACCCCCTGC
TGCCACCGTCTGATTTGCTACAAGTTAACC|GAGTCCAGACCTAAGTTCTATTTCTGCTAC
CCAATCACGCTCGGGCTTCGCTAAACTTTC|CAAGTTAACCCCCTGCTACCACCCCAATCA
CTGCTACCACCCCAATCAGTCTGCCGGAAG|CACCCCAATCAGGCACCTCGTTAATCTTTG
TCTGCTCTGGTCTCTGTAATGTACTTGCTC|GTACTTTGGGACGCGAGTGGCCCAAAACTA
CTACCACCCCAATCAGTCTGCCGGAAGGGA|CCCAATCAGGCACCTCGTTAATCTTTGATT
CCTGCTACCACCCCAATCACCAATCATTTC|ACAGCGACCGCATGGGCTCGATGTACCCGC
AAGGCTGAACGTCTGCTCTGGTCTCTGTAA|CCAATCATTTCGTACTTTGGGACGCGAGTG
CCCCCAAGTTAACCCCCTGCTACCACCCCA|TACTATTCCTTTCCACGCGGCCGGAGTCAC
ACAAGTTAACCCCCTGCTACCACCCCAATC|TAACCCCCTGCTACCACCCCCAAGTTAACC
CTGCTACCACCCCAATCACGGGTGACAAGT|ACGTGAACGATGATACATCGAGACCCTCTA
ACTCGTCCCTAATATCGCCATTCCCTGCTG|ATTTTGCACTGGTGCAGGTGCTTGCCAGAC
TCAGTCTGCCGGAAGGGAAGTCCCATTACC|CCTCGTTAATCTTTGATTAGAGTGAATAGC
CCGCATGGGCTCGATGTACCCGCTTCTGCG|ACGAACGGCCGGCAAGTTAACCCCCTGCTA
CACCCCAATCAGGCACCTCGTTAATCTTTG|CCCCCTGCTACCACCCCAATCAAACTGGAA
TGACGCAAAACACCGCACCGCCAACAAGTT|AAACTTATCAGAACCGCCATCACCCCGTAT
TCACGGGTGACAAGTTAACCCCCTGCTACC|CATCGAGACCCTCTACCGGCAGTCATGCGT
AGAACTTGCATATTCCGGAAGCAAGTTAAC|TAATCTGCGAGTTGTCCGGGAGACAGAGAC
TCGCTAATCTGCGAGTTGTCCGGGAGACAG|TATCGCCATTCCCTGCTGCTGATGCTTCGG
TTTCTATCCTTGTCGATAAGCATCACGAGT|AAGTTAACCCCCTGCTACCACCCCAATCAC
CGTCCCTAATATCGCCATTCCCTGCTGCTG|TTGCACTGGTGCAGGTGCTTGCCAGACACT
CCCTGCTACCACCCCAATCAGGCACCTCGT|ACAAGTTAACCCCCTGCTACCACCCCAATC
CGCATGGGCTCGATGTACCCGCTTCTGCGC|CGAACGGCCGGCAAGTTAACCCCCTGCTAC
TTAACCCCCTGCTACCACCCCAATCAAACT|AAGTTAACCCCCTGCTACCACCCCAATCAA
CTCACATTCTGAATGAGTCATTACGGGTCG|CGGCTCAAAAAAGCCACTCGTCCCTAATAT
GACGCAAAACACCGCACCGCCAACAAGTTA|AACTTATCAGAACCGCCATCACCCCGTATC
CACGTGAACGATGATACATCGAGACCCTCT|AGTTAACCCCCTGCTACCACCCCAATCACC
GCGCCCCTTCCTATGTGGTTTGTTTCTATC|GCTGAGAGTCACTTTGAAATGCAAGTTAAC
TCGAGACCCTCTACCGGCAGTCATGCGTCT|ACCCCAATCACCCGCTCTTCCCACGGAGGC
AACCCCCTGCTACCACCCCAATCAAACTGG|GTTAACCCCCTGCTACCACCCCAATCAATT
GACCGCATGGGCTCGATGTACCCGCTTCTG|TAACGAACGGCCGGCAAGTTAACCCCCTGC
AGTCACTGGGATGACAACACCAGGTGCGAT|TGCTACCACCCCAATCATCGGACGACACTA
ACCGCACCGCCAACAAGTTAACCCCCTGCT|AACCGCCATCACCCCGTATCGGACCTCGGA
TCACTCCACCAAGTTAACCCCCTGCTACCA|AGGGAAGTCCCATTACCGGGAGGGCGACAA
ACTATGTAAACTTATCAGAACCGCCATCAC|TCAAATCAGTACTGGACTGGTTTAGTCTCA
CCACCCCAATCACGGGTGACAAGTTAACCC|ACGATGATACATCGAGACCCTCTACCGGCA
AACTTATCAGAACCGCCATCACCCCGTATC|GTACTGGACTGGTTTAGTCTCACATTCTGA
TAAGCATCACGAGTCCAGACCTAAGTTCTA|ACCACCCCAATCACGGCACTTGACGCAAAA
AAACTTATCAGAACCGCCATCACCCCGTAT|AGTACTGGACTGGTTTAGTCTCACATTCTG
CGTCCCAAGTTAACCCCCTGCTACCACCCC|GGTGACAAGTTAACCCCCTGCTACCACCCA
GGCTCAAAAAAGCCACTCGTCCCTAATATC|TGCCAGTACTTGGCATTTTGCACTGGTGCA
TGGCCGTCCCAAGTTAACCCCCTGCTACCA|CACGGGTGACAAGTTAACCCCCTGCTACCA
CAATGCCACCGTCTGATTTGCTACAAGTTA|CACGAGTCCAGACCTAAGTTCTATTTCTGC
TGAACAGCGTGGCCGTCCCAAGTTAACCCC|CACCCCAATCACGGGTGACAAGTTAACCCC
AGTCTGCCGGAAGGGAAGTCCCATTACCGG|TCGTTAATCTTTGATTAGAGTGAATAGCGC
CAAGTTAACCCCCTGCTACCACCCCAATCA|CAACAAGTTAACCCCCTGCTACCACCCCAA
GCACTTGACGCAAAACACCGCACCGCCAAC|TATGTAAACTTATCAGAACCGCCATCACCC
CGCAAAACACCGCACCGCCAACAAGTTAAC|CTTATCAGAACCGCCATCACCCCGTATCGG
TAACCCCCTGCTACCACCCCAATCAAATCA|TTTCCACGCGGCCGGAGTCACTGGGATGAC
GTTAACCCCCTGCTACCACCCCAATCACCA|ATGGGCAGACAGCGACCGCATGGGCTCGAT
TGCCATCAACCTACTATTCCTTTCCACGCG|ACTGATTGTGAACCCCAGAGTACAAGTTAA
GCATCACGAGTCCAGACCTAAGTTCTATTT|ACCCCAATCACGGCACTTGACGCAAAACAC
GCCGGCAAGTTAACCCCCTGCTACCACCCC|AGTTAACCCCCTGCTACCACCCCAATCAGG
GAGGCGTAGGACAGATTGCCGTTAACGAAC|TCACGGCAATGCCACCGTCTGATTTGCTAC
CAGAAATAGACTGAACAGCGTGGCCGTCCC|CCCCCTGCTACCACCCCAATCACGGGTGAC
CATTACGGGTCGCTAATCTGCGAGTTGTCC|CGTCCCTAATATCGCCATTCCCTGCTGCTG
ACCCGCTCTTCCCACGGAGGCGTAGGACAG|CCTGCTACCACCCCAATCACGGCAATGCCA
CGTACTTTGGGACGCGAGTGGCCCAAAACT|CTTCTGCGCCTACAATGAACTTTACGAGAT
TTAACCCCCTGCTACCACCCCAATCACCAA|TGGGCAGACAGCGACCGCATGGGCTCGATG
TAGAGTGAATAGCGCCCCTTCCTATGTGGT|ACCGCTTGAGAGCTGAGAGTCACTTTGAAA
GCTACCACCCCAATCAAATCAGTACTGGAC|GGCCGGAGTCACTGGGATGACAACACCAGG
TGATTAGAGTGAATAGCGCCCCTTCCTATG|AAACACCGCTTGAGAGCTGAGAGTCACTTT
ACTGGTTTAGTCTCACATTCTGAATGAGTC|GGTGCGATGTTCGGCTCAAAAAAGCCACTC
AAACACCGCACCGCCAACAAGTTAACCCCC|TCAGAACCGCCATCACCCCGTATCGGACCT
GAGCTGAGAGTCACTTTGAAATGCAAGTTA|TGACTCACAAGTTAACCCCCTGCTACCACC
ATCACCAATCATTTCGTACTTTGGGACGCG|GCTCGATGTACCCGCTTCTGCGCCTACAAT
AATCAGTCTGCCGGAAGGGAAGTCCCATTA|CACCTCGTTAATCTTTGATTAGAGTGAATA
CCTGCTACCACCCCAATCACGGGTGACAAG|CACGTGAACGATGATACATCGAGACCCTCT
CCCCCTGCTACCACCCCAATCAATTAGGGG|GACCTCGGAGTGCTGCCCAGAACTTGCATA
GGCCGGAGTCACTGGGATGACAACACCAGG|ACCCCCTGCTACCACCCCAATCATCGGACG
ATGTGGTTTGTTTCTATCCTTGTCGATAAG|TTTGAAATGCAAGTTAACCCCCTGCTACCA
CTTTACGAGATTCACTCCACCAAGTTAACC|AGTCTGCCGGAAGGGAAGTCCCATTACCGG
GGAGGGCGACAAGTTAACCCCCTGCTACCA|CCCCTTCCTATGTGGTTTGTTTCTATCCTT
TACTTGCTCAAGTTAACCCCCTGCTACCAC|CCAAAACTAATCTGTGGCCCACGTGAACGA
CCCCCTGCTACCACCCAAGTTAACCCCCTG|GCAGTCATGCGTCTCGAAATGGGCAGACAG
CTGAATGAGTCATTACGGGTCGCTAATCTG|AAAAGCCACTCGTCCCTAATATCGCCATTC
TGTAATGTACTTGCTCAAGTTAACCCCCTG|GAGTGGCCCAAAACTAATCTGTGGCCCACG
AATCATTCGCATATCTGTAATACTATGTAA|AACCCCCTGCTACCACCCCAATCAAATCAG
GGTTTAGTCTCACATTCTGAATGAGTCATT|GCGATGTTCGGCTCAAAAAAGCCACTCGTC
AATCCAGTGACTCACAAGTTAACCCCCTGC|TCCGGAAGCAAGTTAACCCCCTGCTACCAC
GCTACACAAGTTAACCCCCTGCTACCACCC|CACCGCCAACAAGTTAACCCCCTGCTACCA
CATATTCCGGAAGCAAGTTAACCCCCTGCT|GAGTTGTCCGGGAGACAGAGACTTGCCATC
TCAGTACTGGACTGGTTTAGTCTCACATTC|GACAACACCAGGTGCGATGTTCGGCTCAAA
CCCAATCACCAATCATTTCGTACTTTGGGA|ATGGGCTCGATGTACCCGCTTCTGCGCCTA
TTAACCCCCTGCTACCACCCCAATCATTCG|CCCTGCTACCACCCCCAAGTTAACCCCCTG
ACCCCCTGCTACCACCCCAATCAAACTGGA|TTAACCCCCTGCTACCACCCCAATCAATTA
CGAACGGCCGGCAAGTTAACCCCCTGCTAC|GCTACAAGTTAACCCCCTGCTACCACCCCA
ATCAAATCAGTACTGGACTGGTTTAGTCTC|TGGGATGACAACACCAGGTGCGATGTTCGG
AGACTGAACAGCGTGGCCGTCCCAAGTTAA|CTACCACCCCAATCACGGGTGACAAGTTAA
TCTGATTTGCTACAAGTTAACCCCCTGCTA|ACCTAAGTTCTATTTCTGCTACACAAGTTA
TGGCCCAAAACTAATCTGTGGCCCACGTGA|ACTTTACGAGATTCACTCCACCAAGTTAAC
CTGCTACACAAGTTAACCCCCTGCTACCAC|CGCACCGCCAACAAGTTAACCCCCTGCTAC
AAGCATCACGAGTCCAGACCTAAGTTCTAT|CCACCCCAATCACGGCACTTGACGCAAAAC
TGCTACCACCCCAATCATTCGCATATCTGT|CACCCCCAAGTTAACCCCCTGCTACCACCC
GCTACAAGTTAACCCCCTGCTACCACCCCA|TCTATTTCTGCTACACAAGTTAACCCCCTG
CTACCACCCCAATCACGGCACTTGACGCAA|TCGCATATCTGTAATACTATGTAAACTTAT
AGGCTGAACGTCTGCTCTGGTCTCTGTAAT|CAATCATTTCGTACTTTGGGACGCGAGTGG
CGCCTACAATGAACTTTACGAGATTCACTC|TACCACCCCAATCAGTCTGCCGGAAGGGAA
AGTTAACCCCCTGCTACCACCCAAGTTAAC|CTACCGGCAGTCATGCGTCTCGAAATGGGC
CCAACAAGTTAACCCCCTGCTACCACCCCA|CACCCCGTATCGGACCTCGGAGTGCTGCCC
CCCTGCTACCACCCCAATCAGTCTGCCGGA|ACCACCCCAATCAGGCACCTCGTTAATCTT
CCGCACCGCCAACAAGTTAACCCCCTGCTA|ACCGCCATCACCCCGTATCGGACCTCGGAG
CGTCTGATTTGCTACAAGTTAACCCCCTGC|AGACCTAAGTTCTATTTCTGCTACACAAGT
AACCCCCTGCTACCACCCAAGTTAACCCCC|CGGCAGTCATGCGTCTCGAAATGGGCAGAC
AAGTTAACCCCCTGCTACCACCCCAATCAT|ACCCCCTGCTACCACCCCCAAGTTAACCCC
TTCACTCCACCAAGTTAACCCCCTGCTACC|AAGGGAAGTCCCATTACCGGGAGGGCGACA
ATATCGCCATTCCCTGCTGCTGATGCTTCG|GTGCAGGTGCTTGCCAGACACTCATAAAGA
GTGCGATGTTCGGCTCAAAAAAGCCACTCG|GACACTATTTGTGCCAGTACTTGGCATTTT
TACCACCCCCAAGTTAACCCCCTGCTACCA|CAACCTACTATTCCTTTCCACGCGGCCGGA
TGTCGATAAGCATCACGAGTCCAGACCTAA|CCTGCTACCACCCCAATCACGGCACTTGAC
TTACGGGTCGCTAATCTGCGAGTTGTCCGG|TCCCTAATATCGCCATTCCCTGCTGCTGAT
AAACACCGCTTGAGAGCTGAGAGTCACTTT|AGGGGAAATCCAGTGACTCACAAGTTAACC
CTATCCTTGTCGATAAGCATCACGAGTCCA|TTAACCCCCTGCTACCACCCCAATCACGGC
CAACACCAGGTGCGATGTTCGGCTCAAAAA|TCATCGGACGACACTATTTGTGCCAGTACT
AAGTTAACCCCCTGCTACCACCCCAATCAA|TTCCTTTCCACGCGGCCGGAGTCACTGGGA
TAACCCCCTGCTACCACCCCAATCATTCGC|CCTGCTACCACCCCCAAGTTAACCCCCTGC
ACCCCCTGCTACCACCCCAATCACGGCACT|CCAATCATTCGCATATCTGTAATACTATGT
GTTAACCCCCTGCTACCACCCCAATCACGC|GTTAACCCCCTGCTACCACCCAAGTTAACC
TGCTGCCCAGAACTTGCATATTCCGGAAGC|CGGGTCGCTAATCTGCGAGTTGTCCGGGAG
CCCTGCTACCACCCCCAAGTTAACCCCCTG|TGCCATCAACCTACTATTCCTTTCCACGCG
AGAGTCACTTTGAAATGCAAGTTAACCCCC|ACAAGTTAACCCCCTGCTACCACCCCAATC
CAGTCTGCCGGAAGGGAAGTCCCATTACCG|CTCGTTAATCTTTGATTAGAGTGAATAGCG
CGTCTCGAAATGGGCAGACAGCGACCGCAT|GAGGCGTAGGACAGATTGCCGTTAACGAAC
CCCGCTCTTCCCACGGAGGCGTAGGACAGA|CTGCTACCACCCCAATCACGGCAATGCCAC
TTTGATTAGAGTGAATAGCGCCCCTTCCTA|GGAAACACCGCTTGAGAGCTGAGAGTCACT
TGTAATACTATGTAAACTTATCAGAACCGC|CCCCAATCAAATCAGTACTGGACTGGTTTA
CAAGTTAACCCCCTGCTACCACCCCCAAGT|GACAGAGACTTGCCATCAACCTACTATTCC
CAATCACGGCACTTGACGCAAAACACCGCA|TGTAATACTATGTAAACTTATCAGAACCGC
AGCGACCGCATGGGCTCGATGTACCCGCTT|CGTTAACGAACGGCCGGCAAGTTAACCCCC
CCAAGTTAACCCCCTGCTACCACCCCAATC|CCCATTACCGGGAGGGCGACAAGTTAACCC
GGTCTCTGTAATGTACTTGCTCAAGTTAAC|GGACGCGAGTGGCCCAAAACTAATCTGTGG
CTCTACCGGCAGTCATGCGTCTCGAAATGG|CACCCGCTCTTCCCACGGAGGCGTAGGACA
ACTTGCCATCAACCTACTATTCCTTTCCAC|AGTACTGATTGTGAACCCCAGAGTACAAGT
AATCACGGCAATGCCACCGTCTGATTTGCT|ATAAGCATCACGAGTCCAGACCTAAGTTCT
CAAAAAAGCCACTCGTCCCTAATATCGCCA|AGTACTTGGCATTTTGCACTGGTGCAGGTG
AACCCCCTGCTACCACCCCAATCACCAATC|GGCAGACAGCGACCGCATGGGCTCGATGTA
GTCTCACATTCTGAATGAGTCATTACGGGT|TTCGGCTCAAAAAAGCCACTCGTCCCTAAT
ACATTCTGAATGAGTCATTACGGGTCGCTA|CTCAAAAAAGCCACTCGTCCCTAATATCGC
AGCAAGTTAACCCCCTGCTACCACCCCCAA|GAGACAGAGACTTGCCATCAACCTACTATT
TCAGAACCGCCATCACCCCGTATCGGACCT|GACTGGTTTAGTCTCACATTCTGAATGAGT
TACGGGTCGCTAATCTGCGAGTTGTCCGGG|CCCTAATATCGCCATTCCCTGCTGCTGATG
TTAACCCCCTGCTACCACCCCAATCACGGG|TGTGGCCCACGTGAACGATGATACATCGAG
GACTGGTTTAGTCTCACATTCTGAATGAGT|AGGTGCGATGTTCGGCTCAAAAAAGCCACT
TCTGCCGGAAGGGAAGTCCCATTACCGGGA|GTTAATCTTTGATTAGAGTGAATAGCGCCC
CCCCAATCACGGGTGACAAGTTAACCCCCT|ATGATACATCGAGACCCTCTACCGGCAGTC
GCGTAGGACAGATTGCCGTTAACGAACGGC|CGGCAATGCCACCGTCTGATTTGCTACAAG
TACCGGGAGGGCGACAAGTTAACCCCCTGC|TAGCGCCCCTTCCTATGTGGTTTGTTTCTA
ACCTCGGAGTGCTGCCCAGAACTTGCATAT|GAGTCATTACGGGTCGCTAATCTGCGAGTT
CGAGATTCACTCCACCAAGTTAACCCCCTG|GCCGGAAGGGAAGTCCCATTACCGGGAGGG
CAGACAGCGACCGCATGGGCTCGATGTACC|ATTGCCGTTAACGAACGGCCGGCAAGTTAA
CGATGATACATCGAGACCCTCTACCGGCAG|CCCTGCTACCACCCCAATCACCCGCTCTTC
AACCGCCATCACCCCGTATCGGACCTCGGA|GGTTTAGTCTCACATTCTGAATGAGTCATT
TTAGGGGAAATCCAGTGACTCACAAGTTAA|TTGCATATTCCGGAAGCAAGTTAACCCCCT
TTAACCCCCTGCTACCACCCCAATCACCCG|TACCGGGAGGGCGACAAGTTAACCCCCTGC
ACTAATCTGTGGCCCACGTGAACGATGATA|GATTCACTCCACCAAGTTAACCCCCTGCTA
TTTCGTACTTTGGGACGCGAGTGGCCCAAA|CCGCTTCTGCGCCTACAATGAACTTTACGA
CGTGAACGATGATACATCGAGACCCTCTAC|TTAACCCCCTGCTACCACCCCAATCACCCG
CTGCTACCACCCCAATCAATTAGGGGAAAT|TCGGAGTGCTGCCCAGAACTTGCATATTCC
CTACTATTCCTTTCCACGCGGCCGGAGTCA|AACCCCAGAGTACAAGTTAACCCCCTGCTA
CCCAAGTTAACCCCCTGCTACCACCCCAAT|GACAAGTTAACCCCCTGCTACCACCCAAGT
AATCTGCGAGTTGTCCGGGAGACAGAGACT|CCATTCCCTGCTGCTGATGCTTCGGTAAGT
GTCCAGACCTAAGTTCTATTTCTGCTACAC|ACGGCACTTGACGCAAAACACCGCACCGCC
CACCCCAATCAAATCAGTACTGGACTGGTT|GAGTCACTGGGATGACAACACCAGGTGCGA
ATCACGGCAATGCCACCGTCTGATTTGCTA|TAAGCATCACGAGTCCAGACCTAAGTTCTA
CCTGCTACCACCCCAATCAGGCACCTCGTT|CAAGTTAACCCCCTGCTACCACCCCAATCA
GTACTGGACTGGTTTAGTCTCACATTCTGA|AACACCAGGTGCGATGTTCGGCTCAAAAAA
TTCAAGGCTGAACGTCTGCTCTGGTCTCTG|TCACCAATCATTTCGTACTTTGGGACGCGA
CGACCGCATGGGCTCGATGTACCCGCTTCT|TTAACGAACGGCCGGCAAGTTAACCCCCTG
TGGTCTCTGTAATGTACTTGCTCAAGTTAA|GGGACGCGAGTGGCCCAAAACTAATCTGTG
AGTCACTTTGAAATGCAAGTTAACCCCCTG|AAGTTAACCCCCTGCTACCACCCCAATCAT
CAGAGACTTGCCATCAACCTACTATTCCTT|CGGTAAGTACTGATTGTGAACCCCAGAGTA
CGGGCTTCGCTAAACTTTCAAGGCTGAACG|CCTGCTACCACCCCAATCACCAATCATTTC
CCACCCCAATCACCCGCTCTTCCCACGGAG|CAAGTTAACCCCCTGCTACCACCCCAATCA
GTGACAAGTTAACCCCCTGCTACCACCCAA|GACCCTCTACCGGCAGTCATGCGTCTCGAA
ATTCGCATATCTGTAATACTATGTAAACTT|CCCTGCTACCACCCCAATCAAATCAGTACT
TGGGACGCGAGTGGCCCAAAACTAATCTGT|GCCTACAATGAACTTTACGAGATTCACTCC
CGGACCTCGGAGTGCTGCCCAGAACTTGCA|AATGAGTCATTACGGGTCGCTAATCTGCGA
CTCGTCCCTAATATCGCCATTCCCTGCTGC|TTTTGCACTGGTGCAGGTGCTTGCCAGACA
AAATGGGCAGACAGCGACCGCATGGGCTCG|AGGACAGATTGCCGTTAACGAACGGCCGGC
AAGTTAACCCCCTGCTACCACCCCAATCAC|ATCTGTGGCCCACGTGAACGATGATACATC
ACAGCGTGGCCGTCCCAAGTTAACCCCCTG|CCCAATCACGGGTGACAAGTTAACCCCCTG
ACGGCAATGCCACCGTCTGATTTGCTACAA|GCATCACGAGTCCAGACCTAAGTTCTATTT
ATGACAACACCAGGTGCGATGTTCGGCTCA|CCAATCATCGGACGACACTATTTGTGCCAG
ACTTGACGCAAAACACCGCACCGCCAACAA|TGTAAACTTATCAGAACCGCCATCACCCCG
CTGAACAGCGTGGCCGTCCCAAGTTAACCC|CCACCCCAATCACGGGTGACAAGTTAACCC
CTACCACCCCAATCATTCGCATATCTGTAA|CCCCCAAGTTAACCCCCTGCTACCACCCCA
GCAGAAATAGACTGAACAGCGTGGCCGTCC|ACCCCCTGCTACCACCCCAATCACGGGTGA
ACCCCAATCACGGCACTTGACGCAAAACAC|TATCTGTAATACTATGTAAACTTATCAGAA
TCGGCTCAAAAAAGCCACTCGTCCCTAATA|TGTGCCAGTACTTGGCATTTTGCACTGGTG
CAATCAAATCAGTACTGGACTGGTTTAGTC|ACTGGGATGACAACACCAGGTGCGATGTTC
AAAAAGCCACTCGTCCCTAATATCGCCATT|TACTTGGCATTTTGCACTGGTGCAGGTGCT
CAAATCAGTACTGGACTGGTTTAGTCTCAC|GGATGACAACACCAGGTGCGATGTTCGGCT
CAAAACACCGCACCGCCAACAAGTTAACCC|TATCAGAACCGCCATCACCCCGTATCGGAC
GGGAGACAGAGACTTGCCATCAACCTACTA|ATGCTTCGGTAAGTACTGATTGTGAACCCC
ACCACCCAAGTTAACCCCCTGCTACCACCC|CGTCTCGAAATGGGCAGACAGCGACCGCAT
TACTATTCCTTTCCACGCGGCCGGAGTCAC|ACCCCAGAGTACAAGTTAACCCCCTGCTAC
AGAGTGAATAGCGCCCCTTCCTATGTGGTT|CCGCTTGAGAGCTGAGAGTCACTTTGAAAT
GCCGGAGTCACTGGGATGACAACACCAGGT|CCCCCTGCTACCACCCCAATCATCGGACGA
AAGTTAACCCCCTGCTACCACCCCAATCAA|CGTATCGGACCTCGGAGTGCTGCCCAGAAC
CCATCAACCTACTATTCCTTTCCACGCGGC|TGATTGTGAACCCCAGAGTACAAGTTAACC
CTCGGGCTTCGCTAAACTTTCAAGGCTGAA|CCCCTGCTACCACCCCAATCACCAATCATT
CTCTTCCCACGGAGGCGTAGGACAGATTGC|TACCACCCCAATCACGGCAATGCCACCGTC
ATCTGCGAGTTGTCCGGGAGACAGAGACTT|CATTCCCTGCTGCTGATGCTTCGGTAAGTA
CCCTCTACCGGCAGTCATGCGTCTCGAAAT|ATCACCCGCTCTTCCCACGGAGGCGTAGGA
CCCCTGCTACCACCCCCAAGTTAACCCCCT|TTGCCATCAACCTACTATTCCTTTCCACGC
CCGCTTCTGCGCCTACAATGAACTTTACGA|ACCCCCTGCTACCACCCCAATCAGTCTGCC
TTCCTTTCCACGCGGCCGGAGTCACTGGGA|AGAGTACAAGTTAACCCCCTGCTACCACCC
CCAATCATTCGCATATCTGTAATACTATGT|TTAACCCCCTGCTACCACCCCAATCAAATC
AACACCGCACCGCCAACAAGTTAACCCCCT|CAGAACCGCCATCACCCCGTATCGGACCTC
TCCACGCGGCCGGAGTCACTGGGATGACAA|CAAGTTAACCCCCTGCTACCACCCCAATCA
TGCTACCACCCCAATCACGGCAATGCCACC|CTATCCTTGTCGATAAGCATCACGAGTCCA
CTACCACCCCAATCAGGCACCTCGTTAATC|TTAACCCCCTGCTACCACCCCAATCAAACT
ATCAGTACTGGACTGGTTTAGTCTCACATT|TGACAACACCAGGTGCGATGTTCGGCTCAA
TAACCCCCTGCTACCACCCCAATCACGGCA|GTTTGTTTCTATCCTTGTCGATAAGCATCA
CCATTACCGGGAGGGCGACAAGTTAACCCC|TGAATAGCGCCCCTTCCTATGTGGTTTGTT
AGGGGAAATCCAGTGACTCACAAGTTAACC|GCATATTCCGGAAGCAAGTTAACCCCCTGC
CTGGAAACACCGCTTGAGAGCTGAGAGTCA|AATTAGGGGAAATCCAGTGACTCACAAGTT
CAATCACGGGTGACAAGTTAACCCCCTGCT|ATACATCGAGACCCTCTACCGGCAGTCATG
GTGGTTTGTTTCTATCCTTGTCGATAAGCA|TGAAATGCAAGTTAACCCCCTGCTACCACC
CCCCAAGTTAACCCCCTGCTACCACCCCAA|ACTATTCCTTTCCACGCGGCCGGAGTCACT
CCAATCAAATCAGTACTGGACTGGTTTAGT|CACTGGGATGACAACACCAGGTGCGATGTT
GCAAAACACCGCACCGCCAACAAGTTAACC|TTATCAGAACCGCCATCACCCCGTATCGGA
ACGATGATACATCGAGACCCTCTACCGGCA|CCCCTGCTACCACCCCAATCACCCGCTCTT
CCGCCATCACCCCGTATCGGACCTCGGAGT|TTTAGTCTCACATTCTGAATGAGTCATTAC
CCCCAATCACGGCACTTGACGCAAAACACC|ATCTGTAATACTATGTAAACTTATCAGAAC
CCTGCTACCACCCCAATCATTCGCATATCT|ACCACCCCCAAGTTAACCCCCTGCTACCAC
GGCACCTCGTTAATCTTTGATTAGAGTGAA|CACCCCAATCAAACTGGAAACACCGCTTGA
CAAGTTAACCCCCTGCTACCACCCCAATCA|AATCTGTGGCCCACGTGAACGATGATACAT
GCTCTTCCCACGGAGGCGTAGGACAGATTG|CTACCACCCCAATCACGGCAATGCCACCGT
CACCCCAATCACGGGTGACAAGTTAACCCC|CGATGATACATCGAGACCCTCTACCGGCAG
CTGCTACCACCCCAATCACCAATCATTTCG|CAGCGACCGCATGGGCTCGATGTACCCGCT
GGATGACAACACCAGGTGCGATGTTCGGCT|CCCCAATCATCGGACGACACTATTTGTGCC
CCGCTCTTCCCACGGAGGCGTAGGACAGAT|TGCTACCACCCCAATCACGGCAATGCCACC
TTTCAAGGCTGAACGTCTGCTCTGGTCTCT|ATCACCAATCATTTCGTACTTTGGGACGCG
AATTAGGGGAAATCCAGTGACTCACAAGTT|ACTTGCATATTCCGGAAGCAAGTTAACCCC
CCGGAAGGGAAGTCCCATTACCGGGAGGGC|ATCTTTGATTAGAGTGAATAGCGCCCCTTC
CAAGTTAACCCCCTGCTACCACCCAAGTTA|CTCTACCGGCAGTCATGCGTCTCGAAATGG
CAAGTTAACCCCCTGCTACCACCCCAATCA|AACCCCCTGCTACCACCCCCAAGTTAACCC
GGCCCACGTGAACGATGATACATCGAGACC|ACCAAGTTAACCCCCTGCTACCACCCCAAT
ACGCTCGGGCTTCGCTAAACTTTCAAGGCT|AACCCCCTGCTACCACCCCAATCACCAATC
GTCGATAAGCATCACGAGTCCAGACCTAAG|CTGCTACCACCCCAATCACGGCACTTGACG
TGCATATTCCGGAAGCAAGTTAACCCCCTG|GCGAGTTGTCCGGGAGACAGAGACTTGCCA
GCTACCACCCCAATCAATTAGGGGAAATCC|GGAGTGCTGCCCAGAACTTGCATATTCCGG
GGAAGCAAGTTAACCCCCTGCTACCACCCC|CGGGAGACAGAGACTTGCCATCAACCTACT
TAACCCCCTGCTACCACCCCCAAGTTAACC|AGACTTGCCATCAACCTACTATTCCTTTCC
CACAAGTTAACCCCCTGCTACCACCCCAAT|GCCAACAAGTTAACCCCCTGCTACCACCCC
CGGAGTCACTGGGATGACAACACCAGGTGC|CCCTGCTACCACCCCAATCATCGGACGACA
CACATTCTGAATGAGTCATTACGGGTCGCT|GCTCAAAAAAGCCACTCGTCCCTAATATCG
CCCCTGCTACCACCCAAGTTAACCCCCTGC|CAGTCATGCGTCTCGAAATGGGCAGACAGC
CGCGAGTGGCCCAAAACTAATCTGTGGCCC|CAATGAACTTTACGAGATTCACTCCACCAA
GACAGATTGCCGTTAACGAACGGCCGGCAA|TGCCACCGTCTGATTTGCTACAAGTTAACC
GGAAATCCAGTGACTCACAAGTTAACCCCC|TATTCCGGAAGCAAGTTAACCCCCTGCTAC
GTAAACTTATCAGAACCGCCATCACCCCGT|TCAGTACTGGACTGGTTTAGTCTCACATTC
GTAGGACAGATTGCCGTTAACGAACGGCCG|GCAATGCCACCGTCTGATTTGCTACAAGTT
TGCGTCTCGAAATGGGCAGACAGCGACCGC|CGGAGGCGTAGGACAGATTGCCGTTAACGA
TTGCATATTCCGGAAGCAAGTTAACCCCCT|TGCGAGTTGTCCGGGAGACAGAGACTTGCC
AGTTAACCCCCTGCTACCACCCCAATCAAA|TCCTTTCCACGCGGCCGGAGTCACTGGGAT
TAATACTATGTAAACTTATCAGAACCGCCA|CCAATCAAATCAGTACTGGACTGGTTTAGT
GCAAGTTAACCCCCTGCTACCACCCCAATC|CTACCACCCCAATCATTCGCATATCTGTAA
AATCAAATCAGTACTGGACTGGTTTAGTCT|CTGGGATGACAACACCAGGTGCGATGTTCG
ACCACCCCAATCAAATCAGTACTGGACTGG|CGGAGTCACTGGGATGACAACACCAGGTGC
AGCATCACGAGTCCAGACCTAAGTTCTATT|CACCCCAATCACGGCACTTGACGCAAAACA
TCTTCCCACGGAGGCGTAGGACAGATTGCC|ACCACCCCAATCACGGCAATGCCACCGTCT
CCCTGCTACCACCCCAATCAAACTGGAAAC|ACCCCCTGCTACCACCCCAATCAATTAGGG
GAACGATGATACATCGAGACCCTCTACCGG|ACCCCCTGCTACCACCCCAATCACCCGCTC
CAGAACCGCCATCACCCCGTATCGGACCTC|ACTGGTTTAGTCTCACATTCTGAATGAGTC
ACCAATCATTTCGTACTTTGGGACGCGAGT|CGATGTACCCGCTTCTGCGCCTACAATGAA
CCACCCCAATCACCAATCATTTCGTACTTT|CCGCATGGGCTCGATGTACCCGCTTCTGCG
GGAAGTCCCATTACCGGGAGGGCGACAAGT|ATTAGAGTGAATAGCGCCCCTTCCTATGTG
GGGCTCGATGTACCCGCTTCTGCGCCTACA|GGCCGGCAAGTTAACCCCCTGCTACCACCC
ACCAAGTTAACCCCCTGCTACCACCCCAAT|TCCCATTACCGGGAGGGCGACAAGTTAACC
CTTCCTATGTGGTTTGTTTCTATCCTTGTC|AGTCACTTTGAAATGCAAGTTAACCCCCTG
CCACCGTCTGATTTGCTACAAGTTAACCCC|GTCCAGACCTAAGTTCTATTTCTGCTACAC
TTGCCATCAACCTACTATTCCTTTCCACGC|TACTGATTGTGAACCCCAGAGTACAAGTTA
TGAAATGCAAGTTAACCCCCTGCTACCACC|CCCCTGCTACCACCCCAATCATTCGCATAT
CCCCTGCTACCACCCCAATCACCCGCTCTT|GGAGGGCGACAAGTTAACCCCCTGCTACCA
GTTTAGTCTCACATTCTGAATGAGTCATTA|CGATGTTCGGCTCAAAAAAGCCACTCGTCC
CCCACGTGAACGATGATACATCGAGACCCT|CAAGTTAACCCCCTGCTACCACCCCAATCA
GTGGCCCAAAACTAATCTGTGGCCCACGTG|AACTTTACGAGATTCACTCCACCAAGTTAA
CCCCAATCAGGCACCTCGTTAATCTTTGAT|CCCTGCTACCACCCCAATCAAACTGGAAAC
TTCTATCCTTGTCGATAAGCATCACGAGTC|AGTTAACCCCCTGCTACCACCCCAATCACG
CCCTGCTACCACCCAAGTTAACCCCCTGCT|AGTCATGCGTCTCGAAATGGGCAGACAGCG
GTTCGGCTCAAAAAAGCCACTCGTCCCTAA|TTTGTGCCAGTACTTGGCATTTTGCACTGG
TCACATTCTGAATGAGTCATTACGGGTCGC|GGCTCAAAAAAGCCACTCGTCCCTAATATC
AACGATGATACATCGAGACCCTCTACCGGC|CCCCCTGCTACCACCCCAATCACCCGCTCT
AAGTTAACCCCCTGCTACCACCCCAATCAG|TTCTGCTACACAAGTTAACCCCCTGCTACC
CGAGTCCAGACCTAAGTTCTATTTCTGCTA|ATCACGGCACTTGACGCAAAACACCGCACC
CCCCTGCTACCACCCCAATCAGTCTGCCGG|TACCACCCCAATCAGGCACCTCGTTAATCT
TATTCCTTTCCACGCGGCCGGAGTCACTGG|CCAGAGTACAAGTTAACCCCCTGCTACCAC
CACCCCAATCACGCTCGGGCTTCGCTAAAC|CACCCAAGTTAACCCCCTGCTACCACCCCA
TTACGAGATTCACTCCACCAAGTTAACCCC|TCTGCCGGAAGGGAAGTCCCATTACCGGGA
CTGCTACCACCCCAATCACGGCACTTGACG|CATTCGCATATCTGTAATACTATGTAAACT
AAATGCAAGTTAACCCCCTGCTACCACCCC|CCTGCTACCACCCCAATCATTCGCATATCT
ACCCCCTGCTACCACCCCAATCACGGCAAT|TTGTTTCTATCCTTGTCGATAAGCATCACG
TTGCCGTTAACGAACGGCCGGCAAGTTAAC|CGTCTGATTTGCTACAAGTTAACCCCCTGC
TCTGTGGCCCACGTGAACGATGATACATCG|ACTCCACCAAGTTAACCCCCTGCTACCACC
TACATCGAGACCCTCTACCGGCAGTCATGC|TACCACCCCAATCACCCGCTCTTCCCACGG
GAGTCACTTTGAAATGCAAGTTAACCCCCT|CAAGTTAACCCCCTGCTACCACCCCAATCA
CCCTGCTACCACCCCAATCACCCGCTCTTC|GAGGGCGACAAGTTAACCCCCTGCTACCAC
ACCCCCTGCTACCACCCCAATCACGCTCGG|ACCCCCTGCTACCACCCAAGTTAACCCCCT
ACTCACAAGTTAACCCCCTGCTACCACCCC|AAGTTAACCCCCTGCTACCACCCCCAAGTT
ATCACCCGCTCTTCCCACGGAGGCGTAGGA|CCCCCTGCTACCACCCCAATCACGGCAATG
CTACCACCCCAATCACGCTCGGGCTTCGCT|CTACCACCCAAGTTAACCCCCTGCTACCAC
GTCTGCTCTGGTCTCTGTAATGTACTTGCT|CGTACTTTGGGACGCGAGTGGCCCAAAACT
CCCCCTGCTACCACCCCAATCAAATCAGTA|CCACGCGGCCGGAGTCACTGGGATGACAAC
TGCGAGTTGTCCGGGAGACAGAGACTTGCC|TCCCTGCTGCTGATGCTTCGGTAAGTACTG
CCCCAATCACCCGCTCTTCCCACGGAGGCG|GTTAACCCCCTGCTACCACCCCAATCACGG
TGGAAACACCGCTTGAGAGCTGAGAGTCAC|ATTAGGGGAAATCCAGTGACTCACAAGTTA
ATAGCGCCCCTTCCTATGTGGTTTGTTTCT|AGAGCTGAGAGTCACTTTGAAATGCAAGTT
ACCCCCAAGTTAACCCCCTGCTACCACCCC|CTACTATTCCTTTCCACGCGGCCGGAGTCA
GGCTCGATGTACCCGCTTCTGCGCCTACAA|GCCGGCAAGTTAACCCCCTGCTACCACCCC
ATCAACCTACTATTCCTTTCCACGCGGCCG|ATTGTGAACCCCAGAGTACAAGTTAACCCC
TCGGACCTCGGAGTGCTGCCCAGAACTTGC|GAATGAGTCATTACGGGTCGCTAATCTGCG
ACCCCAATCAATTAGGGGAAATCCAGTGAC|CTGCCCAGAACTTGCATATTCCGGAAGCAA
TCGTTAATCTTTGATTAGAGTGAATAGCGC|AATCAAACTGGAAACACCGCTTGAGAGCTG
TGTACTTGCTCAAGTTAACCCCCTGCTACC|GCCCAAAACTAATCTGTGGCCCACGTGAAC
CTGCGAGTTGTCCGGGAGACAGAGACTTGC|TTCCCTGCTGCTGATGCTTCGGTAAGTACT
CACGAGTCCAGACCTAAGTTCTATTTCTGC|CAATCACGGCACTTGACGCAAAACACCGCA
GTTAACCCCCTGCTACCACCCAAGTTAACC|TACCGGCAGTCATGCGTCTCGAAATGGGCA
CCCTGCTACCACCCCAATCACGGCACTTGA|ATCATTCGCATATCTGTAATACTATGTAAA
CCTATGTGGTTTGTTTCTATCCTTGTCGAT|CACTTTGAAATGCAAGTTAACCCCCTGCTA
ACGGGTCGCTAATCTGCGAGTTGTCCGGGA|CCTAATATCGCCATTCCCTGCTGCTGATGC
TCTACCGGCAGTCATGCGTCTCGAAATGGG|ACCCGCTCTTCCCACGGAGGCGTAGGACAG
TCAAATCAGTACTGGACTGGTTTAGTCTCA|GGGATGACAACACCAGGTGCGATGTTCGGC
GTTTGTTTCTATCCTTGTCGATAAGCATCA|AATGCAAGTTAACCCCCTGCTACCACCCCA
GTTAATCTTTGATTAGAGTGAATAGCGCCC|TCAAACTGGAAACACCGCTTGAGAGCTGAG
CGGAGTGCTGCCCAGAACTTGCATATTCCG|CATTACGGGTCGCTAATCTGCGAGTTGTCC
CCCCTGCTACCACCCCAATCATTCGCATAT|CTACCACCCCCAAGTTAACCCCCTGCTACC
CCTAATATCGCCATTCCCTGCTGCTGATGC|ACTGGTGCAGGTGCTTGCCAGACACTCATA
CCCAAAACTAATCTGTGGCCCACGTGAACG|TTACGAGATTCACTCCACCAAGTTAACCCC
AACAGCGTGGCCGTCCCAAGTTAACCCCCT|CCCCAATCACGGGTGACAAGTTAACCCCCT
CCTGCTACCACCCCAATCACGGCACTTGAC|TCATTCGCATATCTGTAATACTATGTAAAC
CAAGTTAACCCCCTGCTACCACCCCAATCA|TTTCTGCTACACAAGTTAACCCCCTGCTAC
TTTGTTTCTATCCTTGTCGATAAGCATCAC|ATGCAAGTTAACCCCCTGCTACCACCCCAA
CCCTGCTACCACCCCAATCACGGCAATGCC|TTTCTATCCTTGTCGATAAGCATCACGAGT
CATCACGAGTCCAGACCTAAGTTCTATTTC|CCCCAATCACGGCACTTGACGCAAAACACC
CCAGTGACTCACAAGTTAACCCCCTGCTAC|GGAAGCAAGTTAACCCCCTGCTACCACCCC
CAAACTGGAAACACCGCTTGAGAGCTGAGA|AATCAATTAGGGGAAATCCAGTGACTCACA
ATATTCCGGAAGCAAGTTAACCCCCTGCTA|AGTTGTCCGGGAGACAGAGACTTGCCATCA
CAGACCTAAGTTCTATTTCTGCTACACAAG|GCACTTGACGCAAAACACCGCACCGCCAAC
AATCAATTAGGGGAAATCCAGTGACTCACA|CAGAACTTGCATATTCCGGAAGCAAGTTAA
TAACGAACGGCCGGCAAGTTAACCCCCTGC|TTTGCTACAAGTTAACCCCCTGCTACCACC
ACGCGGCCGGAGTCACTGGGATGACAACAC|GTTAACCCCCTGCTACCACCCCAATCATCG
CAAGTTAACCCCCTGCTACCACCCCAATCA|ATTCCTTTCCACGCGGCCGGAGTCACTGGG
TGCTACCACCCAAGTTAACCCCCTGCTACC|CATGCGTCTCGAAATGGGCAGACAGCGACC
ACTTTGGGACGCGAGTGGCCCAAAACTAAT|CTGCGCCTACAATGAACTTTACGAGATTCA
TAATATCGCCATTCCCTGCTGCTGATGCTT|TGGTGCAGGTGCTTGCCAGACACTCATAAA
TTCGCTAAACTTTCAAGGCTGAACGTCTGC|TACCACCCCAATCACCAATCATTTCGTACT
CGAGACCCTCTACCGGCAGTCATGCGTCTC|CCCCAATCACCCGCTCTTCCCACGGAGGCG
TTGATTAGAGTGAATAGCGCCCCTTCCTAT|GAAACACCGCTTGAGAGCTGAGAGTCACTT
CATTCCCTGCTGCTGATGCTTCGGTAAGTA|TGCTTGCCAGACACTCATAAAGAGGATGGC
TTGTCCGGGAGACAGAGACTTGCCATCAAC|CTGCTGATGCTTCGGTAAGTACTGATTGTG
GAAATAGACTGAACAGCGTGGCCGTCCCAA|CCCTGCTACCACCCCAATCACGGGTGACAA
ATCAATTAGGGGAAATCCAGTGACTCACAA|AGAACTTGCATATTCCGGAAGCAAGTTAAC
ACACCGCTTGAGAGCTGAGAGTCACTTTGA|GGGAAATCCAGTGACTCACAAGTTAACCCC
CCCAATCACGGGTGACAAGTTAACCCCCTG|TGATACATCGAGACCCTCTACCGGCAGTCA
ACCGCCAACAAGTTAACCCCCTGCTACCAC|CCATCACCCCGTATCGGACCTCGGAGTGCT
CTTTCCACGCGGCCGGAGTCACTGGGATGA|GTACAAGTTAACCCCCTGCTACCACCCCAA
CACCCCAATCATTCGCATATCTGTAATACT|CAAGTTAACCCCCTGCTACCACCCCAATCA
GCTACCACCCAAGTTAACCCCCTGCTACCA|ATGCGTCTCGAAATGGGCAGACAGCGACCG
CAAGGCTGAACGTCTGCTCTGGTCTCTGTA|ACCAATCATTTCGTACTTTGGGACGCGAGT
CGCATATCTGTAATACTATGTAAACTTATC|TGCTACCACCCCAATCAAATCAGTACTGGA
CGCTCGGGCTTCGCTAAACTTTCAAGGCTG|ACCCCCTGCTACCACCCCAATCACCAATCA
AGTGAATAGCGCCCCTTCCTATGTGGTTTG|GCTTGAGAGCTGAGAGTCACTTTGAAATGC
GTTAACCCCCTGCTACCACCCCAATCAGTC|CCCTGCTACCACCCCAATCAGGCACCTCGT
CACTCGTCCCTAATATCGCCATTCCCTGCT|CATTTTGCACTGGTGCAGGTGCTTGCCAGA
AAGTCCCATTACCGGGAGGGCGACAAGTTA|TAGAGTGAATAGCGCCCCTTCCTATGTGGT
AGAGCTGAGAGTCACTTTGAAATGCAAGTT|GTGACTCACAAGTTAACCCCCTGCTACCAC
CCCCCTGCTACCACCCCCAAGTTAACCCCC|CTTGCCATCAACCTACTATTCCTTTCCACG
AGTTAACCCCCTGCTACCACCCCAATCAAA|ACAAGTTAACCCCCTGCTACCACCCCAATC
CTGATTTGCTACAAGTTAACCCCCTGCTAC|CCTAAGTTCTATTTCTGCTACACAAGTTAA
GGTCGCTAATCTGCGAGTTGTCCGGGAGAC|AATATCGCCATTCCCTGCTGCTGATGCTTC
CACCCCAATCAAACTGGAAACACCGCTTGA|TACCACCCCAATCAATTAGGGGAAATCCAG
CCCCCTGCTACCACCCCAATCATTCGCATA|GCTACCACCCCCAAGTTAACCCCCTGCTAC
AGTACTGGACTGGTTTAGTCTCACATTCTG|CAACACCAGGTGCGATGTTCGGCTCAAAAA
GGCAGTCATGCGTCTCGAAATGGGCAGACA|TCTTCCCACGGAGGCGTAGGACAGATTGCC
TTCCTATGTGGTTTGTTTCTATCCTTGTCG|GTCACTTTGAAATGCAAGTTAACCCCCTGC
CCAAGTTAACCCCCTGCTACCACCCCAATC|ACAAGTTAACCCCCTGCTACCACCCAAGTT
CAATCACGGCAATGCCACCGTCTGATTTGC|GATAAGCATCACGAGTCCAGACCTAAGTTC
CCAATCAGGCACCTCGTTAATCTTTGATTA|CTGCTACCACCCCAATCAAACTGGAAACAC
TCTTTGATTAGAGTGAATAGCGCCCCTTCC|CTGGAAACACCGCTTGAGAGCTGAGAGTCA
TTCCACGCGGCCGGAGTCACTGGGATGACA|ACAAGTTAACCCCCTGCTACCACCCCAATC
GGGCAGACAGCGACCGCATGGGCTCGATGT|CAGATTGCCGTTAACGAACGGCCGGCAAGT
TGAACGATGATACATCGAGACCCTCTACCG|AACCCCCTGCTACCACCCCAATCACCCGCT
GCTTCTGCGCCTACAATGAACTTTACGAGA|CCCCTGCTACCACCCCAATCAGTCTGCCGG
AATAGCGCCCCTTCCTATGTGGTTTGTTTC|GAGAGCTGAGAGTCACTTTGAAATGCAAGT
AACCCCCTGCTACCACCCCAATCAAATCAG|TTCCACGCGGCCGGAGTCACTGGGATGACA
AACCCCCTGCTACCACCCCAATCACGGCAC|CCCAATCATTCGCATATCTGTAATACTATG
GACTGAACAGCGTGGCCGTCCCAAGTTAAC|TACCACCCCAATCACGGGTGACAAGTTAAC
CTATGTGGTTTGTTTCTATCCTTGTCGATA|ACTTTGAAATGCAAGTTAACCCCCTGCTAC
TGCCGTTAACGAACGGCCGGCAAGTTAACC|GTCTGATTTGCTACAAGTTAACCCCCTGCT
ACAAGTTAACCCCCTGCTACCACCCCAATC|ATTTCTGCTACACAAGTTAACCCCCTGCTA
CTCAAGTTAACCCCCTGCTACCACCCCAAT|CTAATCTGTGGCCCACGTGAACGATGATAC
GAGTGGCCCAAAACTAATCTGTGGCCCACG|TGAACTTTACGAGATTCACTCCACCAAGTT
CCTCTACCGGCAGTCATGCGTCTCGAAATG|TCACCCGCTCTTCCCACGGAGGCGTAGGAC
CGCCCCTTCCTATGTGGTTTGTTTCTATCC|CTGAGAGTCACTTTGAAATGCAAGTTAACC
TATTTCTGCTACACAAGTTAACCCCCTGCT|AACACCGCACCGCCAACAAGTTAACCCCCT
CCACCCCAATCATTCGCATATCTGTAATAC|CCAAGTTAACCCCCTGCTACCACCCCAATC
CCCCTGCTACCACCCCAATCAAATCAGTAC|CACGCGGCCGGAGTCACTGGGATGACAACA
TGGGCTCGATGTACCCGCTTCTGCGCCTAC|CGGCCGGCAAGTTAACCCCCTGCTACCACC
CTTTGAAATGCAAGTTAACCCCCTGCTACC|AACCCCCTGCTACCACCCCAATCATTCGCA
TACCACCCCAATCATTCGCATATCTGTAAT|CCCCAAGTTAACCCCCTGCTACCACCCCAA
GACTTGCCATCAACCTACTATTCCTTTCCA|AAGTACTGATTGTGAACCCCAGAGTACAAG
GGAGTCACTGGGATGACAACACCAGGTGCG|CCTGCTACCACCCCAATCATCGGACGACAC
CCAATCAGTCTGCCGGAAGGGAAGTCCCAT|GGCACCTCGTTAATCTTTGATTAGAGTGAA
GACAACACCAGGTGCGATGTTCGGCTCAAA|AATCATCGGACGACACTATTTGTGCCAGTA
GGACCTCGGAGTGCTGCCCAGAACTTGCAT|ATGAGTCATTACGGGTCGCTAATCTGCGAG
CCGCCAACAAGTTAACCCCCTGCTACCACC|CATCACCCCGTATCGGACCTCGGAGTGCTG
ATCATTCGCATATCTGTAATACTATGTAAA|ACCCCCTGCTACCACCCCAATCAAATCAGT
TAAACTTTCAAGGCTGAACGTCTGCTCTGG|CCCCAATCACCAATCATTTCGTACTTTGGG
AATATCGCCATTCCCTGCTGCTGATGCTTC|GGTGCAGGTGCTTGCCAGACACTCATAAAG
TGCTACCACCCCAATCAAATCAGTACTGGA|CGGCCGGAGTCACTGGGATGACAACACCAG
AAACTAATCTGTGGCCCACGTGAACGATGA|GAGATTCACTCCACCAAGTTAACCCCCTGC
GAAGTCCCATTACCGGGAGGGCGACAAGTT|TTAGAGTGAATAGCGCCCCTTCCTATGTGG
CGGGAGACAGAGACTTGCCATCAACCTACT|GATGCTTCGGTAAGTACTGATTGTGAACCC
GCTAATCTGCGAGTTGTCCGGGAGACAGAG|TCGCCATTCCCTGCTGCTGATGCTTCGGTA
ACCCCAATCACGCTCGGGCTTCGCTAAACT|ACCCAAGTTAACCCCCTGCTACCACCCCAA
AGTTGTCCGGGAGACAGAGACTTGCCATCA|TGCTGCTGATGCTTCGGTAAGTACTGATTG
GTGGCCCACGTGAACGATGATACATCGAGA|CCACCAAGTTAACCCCCTGCTACCACCCCA
GCATATCTGTAATACTATGTAAACTTATCA|GCTACCACCCCAATCAAATCAGTACTGGAC
CCCCCTGCTACCACCCCAATCACCCGCTCT|GGGAGGGCGACAAGTTAACCCCCTGCTACC
TAACCCCCTGCTACCACCCCAATCAGTCTG|CTGCTACCACCCCAATCAGGCACCTCGTTA
TGCGATGTTCGGCTCAAAAAAGCCACTCGT|ACACTATTTGTGCCAGTACTTGGCATTTTG
AACACCAGGTGCGATGTTCGGCTCAAAAAA|CATCGGACGACACTATTTGTGCCAGTACTT
CAAGTTAACCCCCTGCTACCACCCCAATCA|CCGTATCGGACCTCGGAGTGCTGCCCAGAA
ACGGCCGGCAAGTTAACCCCCTGCTACCAC|ACAAGTTAACCCCCTGCTACCACCCCAATC
TAATCTTTGATTAGAGTGAATAGCGCCCCT|AAACTGGAAACACCGCTTGAGAGCTGAGAG
ACAAGTTAACCCCCTGCTACCACCCCAATC|TATGTGGTTTGTTTCTATCCTTGTCGATAA
CCTACTATTCCTTTCCACGCGGCCGGAGTC|GAACCCCAGAGTACAAGTTAACCCCCTGCT
CTGTAATACTATGTAAACTTATCAGAACCG|ACCCCAATCAAATCAGTACTGGACTGGTTT
TTAGAGTGAATAGCGCCCCTTCCTATGTGG|CACCGCTTGAGAGCTGAGAGTCACTTTGAA
AATCAGTACTGGACTGGTTTAGTCTCACAT|ATGACAACACCAGGTGCGATGTTCGGCTCA
CATTCTGAATGAGTCATTACGGGTCGCTAA|TCAAAAAAGCCACTCGTCCCTAATATCGCC
TCACGAGTCCAGACCTAAGTTCTATTTCTG|CCAATCACGGCACTTGACGCAAAACACCGC
TGTGGTTTGTTTCTATCCTTGTCGATAAGC|TTGAAATGCAAGTTAACCCCCTGCTACCAC
GACCCTCTACCGGCAGTCATGCGTCTCGAA|CAATCACCCGCTCTTCCCACGGAGGCGTAG
CCAAAACTAATCTGTGGCCCACGTGAACGA|TACGAGATTCACTCCACCAAGTTAACCCCC
TTGAAATGCAAGTTAACCCCCTGCTACCAC|CCCCCTGCTACCACCCCAATCATTCGCATA
GACCTCGGAGTGCTGCCCAGAACTTGCATA|TGAGTCATTACGGGTCGCTAATCTGCGAGT
GTCATTACGGGTCGCTAATCTGCGAGTTGT|CTCGTCCCTAATATCGCCATTCCCTGCTGC
CAGATTGCCGTTAACGAACGGCCGGCAAGT|CCACCGTCTGATTTGCTACAAGTTAACCCC
CCCCCTGCTACCACCCCAATCAAACTGGAA|TAACCCCCTGCTACCACCCCAATCAATTAG
TCTGCGCCTACAATGAACTTTACGAGATTC|CTGCTACCACCCCAATCAGTCTGCCGGAAG
GTGGCCGTCCCAAGTTAACCCCCTGCTACC|TCACGGGTGACAAGTTAACCCCCTGCTACC
GATACATCGAGACCCTCTACCGGCAGTCAT|GCTACCACCCCAATCACCCGCTCTTCCCAC
ATCACGCTCGGGCTTCGCTAAACTTTCAAG|GTTAACCCCCTGCTACCACCCCAATCACCA
GCTACCACCCCAATCACCAATCATTTCGTA|GCGACCGCATGGGCTCGATGTACCCGCTTC
CTTATCAGAACCGCCATCACCCCGTATCGG|ACTGGACTGGTTTAGTCTCACATTCTGAAT
CCCCTGCTACCACCCCAATCACCAATCATT|AGACAGCGACCGCATGGGCTCGATGTACCC
TGAATGAGTCATTACGGGTCGCTAATCTGC|AAAGCCACTCGTCCCTAATATCGCCATTCC
GCTACCACCCCAATCACGGGTGACAAGTTA|GTGAACGATGATACATCGAGACCCTCTACC
CAGTCATGCGTCTCGAAATGGGCAGACAGC|TTCCCACGGAGGCGTAGGACAGATTGCCGT
CACCGCCAACAAGTTAACCCCCTGCTACCA|GCCATCACCCCGTATCGGACCTCGGAGTGC
GTCCCATTACCGGGAGGGCGACAAGTTAAC|GAGTGAATAGCGCCCCTTCCTATGTGGTTT
AACAAGTTAACCCCCTGCTACCACCCCAAT|CCCCGTATCGGACCTCGGAGTGCTGCCCAG
GCAGACAGCGACCGCATGGGCTCGATGTAC|GATTGCCGTTAACGAACGGCCGGCAAGTTA
TTGACGCAAAACACCGCACCGCCAACAAGT|TAAACTTATCAGAACCGCCATCACCCCGTA
AACCCCCTGCTACCACCCCCAAGTTAACCC|GACTTGCCATCAACCTACTATTCCTTTCCA
CCACGTGAACGATGATACATCGAGACCCTC|AAGTTAACCCCCTGCTACCACCCCAATCAC
CCCCCTGCTACCACCCCAATCACGGCAATG|TGTTTCTATCCTTGTCGATAAGCATCACGA
GTACCCGCTTCTGCGCCTACAATGAACTTT|GTTAACCCCCTGCTACCACCCCAATCAGTC
CCTGCTACCACCCCAATCAAACTGGAAACA|CCCCCTGCTACCACCCCAATCAATTAGGGG
CCCAATCATTCGCATATCTGTAATACTATG|GTTAACCCCCTGCTACCACCCCAATCAAAT
CCCCAATCAAACTGGAAACACCGCTTGAGA|CCACCCCAATCAATTAGGGGAAATCCAGTG
TGCTACCACCCCAATCAGTCTGCCGGAAGG|ACCCCAATCAGGCACCTCGTTAATCTTTGA
CCACGGAGGCGTAGGACAGATTGCCGTTAA|CCCAATCACGGCAATGCCACCGTCTGATTT
GTGCTGCCCAGAACTTGCATATTCCGGAAG|ACGGGTCGCTAATCTGCGAGTTGTCCGGGA
TCTGTAATGTACTTGCTCAAGTTAACCCCC|GCGAGTGGCCCAAAACTAATCTGTGGCCCA
ATGTTCGGCTCAAAAAAGCCACTCGTCCCT|TATTTGTGCCAGTACTTGGCATTTTGCACT
TGTGGCCCACGTGAACGATGATACATCGAG|TCCACCAAGTTAACCCCCTGCTACCACCCC
CTGGTTTAGTCTCACATTCTGAATGAGTCA|GTGCGATGTTCGGCTCAAAAAAGCCACTCG
CACTGGGATGACAACACCAGGTGCGATGTT|TACCACCCCAATCATCGGACGACACTATTT
TATTCCGGAAGCAAGTTAACCCCCTGCTAC|GTTGTCCGGGAGACAGAGACTTGCCATCAA
TTAATCTTTGATTAGAGTGAATAGCGCCCC|CAAACTGGAAACACCGCTTGAGAGCTGAGA
TCAAACTGGAAACACCGCTTGAGAGCTGAG|CAATCAATTAGGGGAAATCCAGTGACTCAC
GAAGGGAAGTCCCATTACCGGGAGGGCGAC|TTTGATTAGAGTGAATAGCGCCCCTTCCTA
TCCTTTCCACGCGGCCGGAGTCACTGGGAT|GAGTACAAGTTAACCCCCTGCTACCACCCC
ATGTACCCGCTTCTGCGCCTACAATGAACT|AAGTTAACCCCCTGCTACCACCCCAATCAG
CTCAAAAAAGCCACTCGTCCCTAATATCGC|CCAGTACTTGGCATTTTGCACTGGTGCAGG
CAAGTTAACCCCCTGCTACCACCCCAATCA|ACCCCCTGCTACCACCCCAATCAGGCACCT
AGTCATGCGTCTCGAAATGGGCAGACAGCG|TCCCACGGAGGCGTAGGACAGATTGCCGTT
CAATCACGCTCGGGCTTCGCTAAACTTTCA|AAGTTAACCCCCTGCTACCACCCCAATCAC
GGCAATGCCACCGTCTGATTTGCTACAAGT|ATCACGAGTCCAGACCTAAGTTCTATTTCT
CCCAAGTTAACCCCCTGCTACCACCCCAAT|CTATTCCTTTCCACGCGGCCGGAGTCACTG
CCCCCTGCTACCACCCCAATCACCAATCAT|CAGACAGCGACCGCATGGGCTCGATGTACC
CCAATCAATTAGGGGAAATCCAGTGACTCA|CCCAGAACTTGCATATTCCGGAAGCAAGTT
GCTACCACCCCAATCAAACTGGAAACACCG|CCTGCTACCACCCCAATCAATTAGGGGAAA
GGCAAGTTAACCCCCTGCTACCACCCCAAT|TAACCCCCTGCTACCACCCCAATCAGGCAC
GGACAGATTGCCGTTAACGAACGGCCGGCA|ATGCCACCGTCTGATTTGCTACAAGTTAAC
CGCCAACAAGTTAACCCCCTGCTACCACCC|ATCACCCCGTATCGGACCTCGGAGTGCTGC
GGAGTGCTGCCCAGAACTTGCATATTCCGG|ATTACGGGTCGCTAATCTGCGAGTTGTCCG
TGATTTGCTACAAGTTAACCCCCTGCTACC|CTAAGTTCTATTTCTGCTACACAAGTTAAC
CAATCAGGCACCTCGTTAATCTTTGATTAG|TGCTACCACCCCAATCAAACTGGAAACACC
CCCCCTGCTACCACCCCAATCAGTCTGCCG|CTACCACCCCAATCAGGCACCTCGTTAATC
TCGTCCCTAATATCGCCATTCCCTGCTGCT|TTTGCACTGGTGCAGGTGCTTGCCAGACAC
TCCTTGTCGATAAGCATCACGAGTCCAGAC|ACCCCCTGCTACCACCCCAATCACGGCACT
AGGGAAGTCCCATTACCGGGAGGGCGACAA|TGATTAGAGTGAATAGCGCCCCTTCCTATG
CGCTTCTGCGCCTACAATGAACTTTACGAG|CCCCCTGCTACCACCCCAATCAGTCTGCCG
TGCTACCACCCCAATCACGGGTGACAAGTT|CGTGAACGATGATACATCGAGACCCTCTAC
CCCCTGCTACCACCCCAATCAATTAGGGGA|ACCTCGGAGTGCTGCCCAGAACTTGCATAT
TCTCACATTCTGAATGAGTCATTACGGGTC|TCGGCTCAAAAAAGCCACTCGTCCCTAATA
TACCACCCAAGTTAACCCCCTGCTACCACC|GCGTCTCGAAATGGGCAGACAGCGACCGCA
TCGGGCTTCGCTAAACTTTCAAGGCTGAAC|CCCTGCTACCACCCCAATCACCAATCATTT
CCACCCCAATCAGTCTGCCGGAAGGGAAGT|AATCAGGCACCTCGTTAATCTTTGATTAGA
TGTACCCGCTTCTGCGCCTACAATGAACTT|AGTTAACCCCCTGCTACCACCCCAATCAGT
CCCCAATCAAATCAGTACTGGACTGGTTTA|GTCACTGGGATGACAACACCAGGTGCGATG
GCTACCACCCCAATCACGGCAATGCCACCG|TATCCTTGTCGATAAGCATCACGAGTCCAG
AGTTAACCCCCTGCTACCACCCCAATCAGT|CCCCTGCTACCACCCCAATCAGGCACCTCG
TCCCACGGAGGCGTAGGACAGATTGCCGTT|ACCCCAATCACGGCAATGCCACCGTCTGAT
TAACCCCCTGCTACCACCCCAATCACGGCA|CCCCAATCATTCGCATATCTGTAATACTAT
CCTAAGTTCTATTTCTGCTACACAAGTTAA|TTGACGCAAAACACCGCACCGCCAACAAGT
CCCCTGCTACCACCCCAATCACGGGTGACA|CCCACGTGAACGATGATACATCGAGACCCT
ACGAGATTCACTCCACCAAGTTAACCCCCT|TGCCGGAAGGGAAGTCCCATTACCGGGAGG
CACCCCAATCACGGCACTTGACGCAAAACA|ATATCTGTAATACTATGTAAACTTATCAGA
CAGTACTGGACTGGTTTAGTCTCACATTCT|ACAACACCAGGTGCGATGTTCGGCTCAAAA
GTCGCTAATCTGCGAGTTGTCCGGGAGACA|ATATCGCCATTCCCTGCTGCTGATGCTTCG
CTGCTACCACCCCAATCATTCGCATATCTG|CCACCCCCAAGTTAACCCCCTGCTACCACC
GGCCCAAAACTAATCTGTGGCCCACGTGAA|CTTTACGAGATTCACTCCACCAAGTTAACC
ACTGAACAGCGTGGCCGTCCCAAGTTAACC|ACCACCCCAATCACGGGTGACAAGTTAACC
ACTTTCAAGGCTGAACGTCTGCTCTGGTCT|CAATCACCAATCATTTCGTACTTTGGGACG
CCTGCTACCACCCCAATCACCCGCTCTTCC|AGGGCGACAAGTTAACCCCCTGCTACCACC
AGTTAACCCCCTGCTACCACCCCAATCACG|GTGGTTTGTTTCTATCCTTGTCGATAAGCA
CCGTCTGATTTGCTACAAGTTAACCCCCTG|CAGACCTAAGTTCTATTTCTGCTACACAAG
CTAAGTTCTATTTCTGCTACACAAGTTAAC|TGACGCAAAACACCGCACCGCCAACAAGTT
CAGTGACTCACAAGTTAACCCCCTGCTACC|GAAGCAAGTTAACCCCCTGCTACCACCCCC
CACCAAGTTAACCCCCTGCTACCACCCCAA|GTCCCATTACCGGGAGGGCGACAAGTTAAC
CAATCAAACTGGAAACACCGCTTGAGAGCT|CCCCAATCAATTAGGGGAAATCCAGTGACT
CAATCATTCGCATATCTGTAATACTATGTA|TAACCCCCTGCTACCACCCCAATCAAATCA
AATGTACTTGCTCAAGTTAACCCCCTGCTA|TGGCCCAAAACTAATCTGTGGCCCACGTGA
TACTATGTAAACTTATCAGAACCGCCATCA|ATCAAATCAGTACTGGACTGGTTTAGTCTC
CTACCACCCCCAAGTTAACCCCCTGCTACC|TCAACCTACTATTCCTTTCCACGCGGCCGG
TCGCCATTCCCTGCTGCTGATGCTTCGGTA|CAGGTGCTTGCCAGACACTCATAAAGAGGA
ACCACCCCAATCACCAATCATTTCGTACTT|ACCGCATGGGCTCGATGTACCCGCTTCTGC
CTGCTACCACCCAAGTTAACCCCCTGCTAC|TCATGCGTCTCGAAATGGGCAGACAGCGAC
GCCGTTAACGAACGGCCGGCAAGTTAACCC|TCTGATTTGCTACAAGTTAACCCCCTGCTA
CCACCAAGTTAACCCCCTGCTACCACCCCA|AGTCCCATTACCGGGAGGGCGACAAGTTAA
CCCTGCTACCACCCCAATCAATTAGGGGAA|CCTCGGAGTGCTGCCCAGAACTTGCATATT
CTACCGGCAGTCATGCGTCTCGAAATGGGC|CCCGCTCTTCCCACGGAGGCGTAGGACAGA
CCCCTGCTACCACCCCAATCACGCTCGGGC|CCCCTGCTACCACCCAAGTTAACCCCCTGC
GAGTCATTACGGGTCGCTAATCTGCGAGTT|CACTCGTCCCTAATATCGCCATTCCCTGCT
TTGTCGATAAGCATCACGAGTCCAGACCTA|CCCTGCTACCACCCCAATCACGGCACTTGA
GCGACCGCATGGGCTCGATGTACCCGCTTC|GTTAACGAACGGCCGGCAAGTTAACCCCCT
CTACCACCCCAATCACCCGCTCTTCCCACG|CGACAAGTTAACCCCCTGCTACCACCCCAA
TTAACCCCCTGCTACCACCCCCAAGTTAAC|GAGACTTGCCATCAACCTACTATTCCTTTC
CACCCCAATCACCAATCATTTCGTACTTTG|CGCATGGGCTCGATGTACCCGCTTCTGCGC
TATGTGGTTTGTTTCTATCCTTGTCGATAA|CTTTGAAATGCAAGTTAACCCCCTGCTACC
TTCGTACTTTGGGACGCGAGTGGCCCAAAA|CGCTTCTGCGCCTACAATGAACTTTACGAG
AGCGCCCCTTCCTATGTGGTTTGTTTCTAT|AGCTGAGAGTCACTTTGAAATGCAAGTTAA
GGTTTGTTTCTATCCTTGTCGATAAGCATC|AAATGCAAGTTAACCCCCTGCTACCACCCC
AAGTTAACCCCCTGCTACCACCCCAATCAC|ACCACCCCAATCATTCGCATATCTGTAATA
ACCCCCTGCTACCACCCCAATCACCCGCTC|CGGGAGGGCGACAAGTTAACCCCCTGCTAC
GCCACCGTCTGATTTGCTACAAGTTAACCC|AGTCCAGACCTAAGTTCTATTTCTGCTACA
CTGCTACCACCCCAATCACGGCAATGCCAC|TCTATCCTTGTCGATAAGCATCACGAGTCC
AAGTTAACCCCCTGCTACCACCCCAATCAC|AAATGGGCAGACAGCGACCGCATGGGCTCG
GACTCACAAGTTAACCCCCTGCTACCACCC|CAAGTTAACCCCCTGCTACCACCCCCAAGT
AATCAGGCACCTCGTTAATCTTTGATTAGA|GCTACCACCCCAATCAAACTGGAAACACCG
TTAACCCCCTGCTACCACCCCAATCAGGCA|TGCTACACAAGTTAACCCCCTGCTACCACC
AATCACGGGTGACAAGTTAACCCCCTGCTA|TACATCGAGACCCTCTACCGGCAGTCATGC
CGTTAATCTTTGATTAGAGTGAATAGCGCC|ATCAAACTGGAAACACCGCTTGAGAGCTGA
CACGGAGGCGTAGGACAGATTGCCGTTAAC|CCAATCACGGCAATGCCACCGTCTGATTTG
CAGCGTGGCCGTCCCAAGTTAACCCCCTGC|CCAATCACGGGTGACAAGTTAACCCCCTGC
AATCACCCGCTCTTCCCACGGAGGCGTAGG|ACCCCCTGCTACCACCCCAATCACGGCAAT
CTCACAAGTTAACCCCCTGCTACCACCCCA|AGTTAACCCCCTGCTACCACCCCCAAGTTA
TGCTACCACCCCAATCACGCTCGGGCTTCG|TGCTACCACCCAAGTTAACCCCCTGCTACC
CCCCTGCTACCACCCCAATCACGGCACTTG|AATCATTCGCATATCTGTAATACTATGTAA
ATGCCACCGTCTGATTTGCTACAAGTTAAC|CGAGTCCAGACCTAAGTTCTATTTCTGCTA
AATCAAACTGGAAACACCGCTTGAGAGCTG|CCCAATCAATTAGGGGAAATCCAGTGACTC
CCACCCCAATCACGCTCGGGCTTCGCTAAA|CCACCCAAGTTAACCCCCTGCTACCACCCC
CGAAATGGGCAGACAGCGACCGCATGGGCT|GTAGGACAGATTGCCGTTAACGAACGGCCG
AGTTAACCCCCTGCTACCACCCCAATCACC|AATGGGCAGACAGCGACCGCATGGGCTCGA
CCCCAATCACCAATCATTTCGTACTTTGGG|CATGGGCTCGATGTACCCGCTTCTGCGCCT
TTAACCCCCTGCTACCACCCCAATCAAATC|CTTTCCACGCGGCCGGAGTCACTGGGATGA
GCTCGGGCTTCGCTAAACTTTCAAGGCTGA|CCCCCTGCTACCACCCCAATCACCAATCAT
TTAACCCCCTGCTACCACCCCAATCACGCT|TTAACCCCCTGCTACCACCCAAGTTAACCC
CCCCTGCTACCACCCCAATCAGGCACCTCG|CACAAGTTAACCCCCTGCTACCACCCCAAT
ACAGCGACCGCATGGGCTCGATGTACCCGC|GCCGTTAACGAACGGCCGGCAAGTTAACCC
CTACAATGAACTTTACGAGATTCACTCCAC|CACCCCAATCAGTCTGCCGGAAGGGAAGTC
ACCACCCCAATCACGGCACTTGACGCAAAA|GCATATCTGTAATACTATGTAAACTTATCA
GCCCCTTCCTATGTGGTTTGTTTCTATCCT|TGAGAGTCACTTTGAAATGCAAGTTAACCC
CAACCTACTATTCCTTTCCACGCGGCCGGA|TGTGAACCCCAGAGTACAAGTTAACCCCCT
CGGAAGCAAGTTAACCCCCTGCTACCACCC|CCGGGAGACAGAGACTTGCCATCAACCTAC
CCCAATCACGGCAATGCCACCGTCTGATTT|TCGATAAGCATCACGAGTCCAGACCTAAGT
TTAACCCCCTGCTACCACCCCAATCAATTA|ATCGGACCTCGGAGTGCTGCCCAGAACTTG
AGCCACTCGTCCCTAATATCGCCATTCCCT|TGGCATTTTGCACTGGTGCAGGTGCTTGCC
ATGGGCTCGATGTACCCGCTTCTGCGCCTA|ACGGCCGGCAAGTTAACCCCCTGCTACCAC
GAACTTGCATATTCCGGAAGCAAGTTAACC|AATCTGCGAGTTGTCCGGGAGACAGAGACT
TAGGGGAAATCCAGTGACTCACAAGTTAAC|TGCATATTCCGGAAGCAAGTTAACCCCCTG
GCGAGTGGCCCAAAACTAATCTGTGGCCCA|AATGAACTTTACGAGATTCACTCCACCAAG
GCTGAGAGTCACTTTGAAATGCAAGTTAAC|ACTCACAAGTTAACCCCCTGCTACCACCCC
AGTCATTACGGGTCGCTAATCTGCGAGTTG|ACTCGTCCCTAATATCGCCATTCCCTGCTG
GAGTCCAGACCTAAGTTCTATTTCTGCTAC|TCACGGCACTTGACGCAAAACACCGCACCG
GGCGACAAGTTAACCCCCTGCTACCACCCC|TTCCTATGTGGTTTGTTTCTATCCTTGTCG
CGACAAGTTAACCCCCTGCTACCACCCCAA|CCTATGTGGTTTGTTTCTATCCTTGTCGAT
CACCCGCTCTTCCCACGGAGGCGTAGGACA|CCCTGCTACCACCCCAATCACGGCAATGCC
CCACTCGTCCCTAATATCGCCATTCCCTGC|GCATTTTGCACTGGTGCAGGTGCTTGCCAG
AGTCTCACATTCTGAATGAGTCATTACGGG|GTTCGGCTCAAAAAAGCCACTCGTCCCTAA
ATGCGTCTCGAAATGGGCAGACAGCGACCG|ACGGAGGCGTAGGACAGATTGCCGTTAACG
GCTAAACTTTCAAGGCTGAACGTCTGCTCT|CACCCCAATCACCAATCATTTCGTACTTTG
GATGTTCGGCTCAAAAAAGCCACTCGTCCC|CTATTTGTGCCAGTACTTGGCATTTTGCAC
GCTGAACGTCTGCTCTGGTCTCTGTAATGT|ATCATTTCGTACTTTGGGACGCGAGTGGCC
TTACCGGGAGGGCGACAAGTTAACCCCCTG|ATAGCGCCCCTTCCTATGTGGTTTGTTTCT
TAATGTACTTGCTCAAGTTAACCCCCTGCT|GTGGCCCAAAACTAATCTGTGGCCCACGTG
TTTGAAATGCAAGTTAACCCCCTGCTACCA|ACCCCCTGCTACCACCCCAATCATTCGCAT
ACCCGCTTCTGCGCCTACAATGAACTTTAC|TAACCCCCTGCTACCACCCCAATCAGTCTG
TCAATTAGGGGAAATCCAGTGACTCACAAG|GAACTTGCATATTCCGGAAGCAAGTTAACC
AACCCCCTGCTACCACCCCAATCATTCGCA|CTGCTACCACCCCCAAGTTAACCCCCTGCT
AAGTTAACCCCCTGCTACCACCCCAATCAC|CATTACCGGGAGGGCGACAAGTTAACCCCC
GGAGGCGTAGGACAGATTGCCGTTAACGAA|ATCACGGCAATGCCACCGTCTGATTTGCTA
CCCAGAACTTGCATATTCCGGAAGCAAGTT|CGCTAATCTGCGAGTTGTCCGGGAGACAGA
TATCAGAACCGCCATCACCCCGTATCGGAC|TGGACTGGTTTAGTCTCACATTCTGAATGA
CTAATCTGCGAGTTGTCCGGGAGACAGAGA|CGCCATTCCCTGCTGCTGATGCTTCGGTAA
ATCTGTAATACTATGTAAACTTATCAGAAC|CCACCCCAATCAAATCAGTACTGGACTGGT
CCCAATCACCCGCTCTTCCCACGGAGGCGT|TTAACCCCCTGCTACCACCCCAATCACGGC
GTACTTGCTCAAGTTAACCCCCTGCTACCA|CCCAAAACTAATCTGTGGCCCACGTGAACG
CCACCCCAATCACGGCACTTGACGCAAAAC|CATATCTGTAATACTATGTAAACTTATCAG
GGAAGGGAAGTCCCATTACCGGGAGGGCGA|CTTTGATTAGAGTGAATAGCGCCCCTTCCT
CCCGTATCGGACCTCGGAGTGCTGCCCAGA|CATTCTGAATGAGTCATTACGGGTCGCTAA
AACGAACGGCCGGCAAGTTAACCCCCTGCT|TTGCTACAAGTTAACCCCCTGCTACCACCC
GATAAGCATCACGAGTCCAGACCTAAGTTC|CTACCACCCCAATCACGGCACTTGACGCAA
GTGACTCACAAGTTAACCCCCTGCTACCAC|AGCAAGTTAACCCCCTGCTACCACCCCCAA
CGCGGCCGGAGTCACTGGGATGACAACACC|TTAACCCCCTGCTACCACCCCAATCATCGG
TCTATCCTTGTCGATAAGCATCACGAGTCC|GTTAACCCCCTGCTACCACCCCAATCACGG
CTACCACCCCAATCAAACTGGAAACACCGC|CTGCTACCACCCCAATCAATTAGGGGAAAT
CGGCCGGAGTCACTGGGATGACAACACCAG|AACCCCCTGCTACCACCCCAATCATCGGAC
AAGTTAACCCCCTGCTACCACCCCAATCAC|TGTGGTTTGTTTCTATCCTTGTCGATAAGC
ACCGCATGGGCTCGATGTACCCGCTTCTGC|AACGAACGGCCGGCAAGTTAACCCCCTGCT
TCGTACTTTGGGACGCGAGTGGCCCAAAAC|GCTTCTGCGCCTACAATGAACTTTACGAGA
GTTAACCCCCTGCTACCACCCCAATCACGG|CTGTGGCCCACGTGAACGATGATACATCGA
ACGAGTCCAGACCTAAGTTCTATTTCTGCT|AATCACGGCACTTGACGCAAAACACCGCAC
CACTTTGAAATGCAAGTTAACCCCCTGCTA|TTAACCCCCTGCTACCACCCCAATCATTCG
TGCTACCACCCCCAAGTTAACCCCCTGCTA|CATCAACCTACTATTCCTTTCCACGCGGCC
CCGTTAACGAACGGCCGGCAAGTTAACCCC|CTGATTTGCTACAAGTTAACCCCCTGCTAC
AACTTTACGAGATTCACTCCACCAAGTTAA|TCAGTCTGCCGGAAGGGAAGTCCCATTACC
ACGGCACTTGACGCAAAACACCGCACCGCC|TACTATGTAAACTTATCAGAACCGCCATCA
GAACAGCGTGGCCGTCCCAAGTTAACCCCC|ACCCCAATCACGGGTGACAAGTTAACCCCC
GTATCGGACCTCGGAGTGCTGCCCAGAACT|TCTGAATGAGTCATTACGGGTCGCTAATCT
CAGAACTTGCATATTCCGGAAGCAAGTTAA|CTAATCTGCGAGTTGTCCGGGAGACAGAGA
CGCCATTCCCTGCTGCTGATGCTTCGGTAA|AGGTGCTTGCCAGACACTCATAAAGAGGAT
GTAATACTATGTAAACTTATCAGAACCGCC|CCCAATCAAATCAGTACTGGACTGGTTTAG
AACTGGAAACACCGCTTGAGAGCTGAGAGT|TCAATTAGGGGAAATCCAGTGACTCACAAG
TTTCTGCTACACAAGTTAACCCCCTGCTAC|CACCGCACCGCCAACAAGTTAACCCCCTGC
ACGCAAAACACCGCACCGCCAACAAGTTAA|ACTTATCAGAACCGCCATCACCCCGTATCG
TAGGACAGATTGCCGTTAACGAACGGCCGG|CAATGCCACCGTCTGATTTGCTACAAGTTA
CATTACCGGGAGGGCGACAAGTTAACCCCC|GAATAGCGCCCCTTCCTATGTGGTTTGTTT
TACCACCCCAATCACGGCAATGCCACCGTC|TCCTTGTCGATAAGCATCACGAGTCCAGAC
CAAGTTAACCCCCTGCTACCACCCCAATCA|ATGTGGTTTGTTTCTATCCTTGTCGATAAG
TCTGTAATACTATGTAAACTTATCAGAACC|CACCCCAATCAAATCAGTACTGGACTGGTT
GAAATGCAAGTTAACCCCCTGCTACCACCC|CCCTGCTACCACCCCAATCATTCGCATATC
TCTATTTCTGCTACACAAGTTAACCCCCTG|AAAACACCGCACCGCCAACAAGTTAACCCC
AAAAAAGCCACTCGTCCCTAATATCGCCAT|GTACTTGGCATTTTGCACTGGTGCAGGTGC
GACAAGTTAACCCCCTGCTACCACCCAAGT|CCCTCTACCGGCAGTCATGCGTCTCGAAAT
ACCCCCTGCTACCACCCCAATCACGGGTGA|GGCCCACGTGAACGATGATACATCGAGACC
TCGGAGTGCTGCCCAGAACTTGCATATTCC|TCATTACGGGTCGCTAATCTGCGAGTTGTC
GTCCCTAATATCGCCATTCCCTGCTGCTGA|TGCACTGGTGCAGGTGCTTGCCAGACACTC
ATCCAGTGACTCACAAGTTAACCCCCTGCT|CCGGAAGCAAGTTAACCCCCTGCTACCACC
ATGAGTCATTACGGGTCGCTAATCTGCGAG|GCCACTCGTCCCTAATATCGCCATTCCCTG
GCTACCACCCCAATCACCCGCTCTTCCCAC|GCGACAAGTTAACCCCCTGCTACCACCCCA
GTCACTGGGATGACAACACCAGGTGCGATG|GCTACCACCCCAATCATCGGACGACACTAT
TCACGGCACTTGACGCAAAACACCGCACCG|AATACTATGTAAACTTATCAGAACCGCCAT
CGCTCTTCCCACGGAGGCGTAGGACAGATT|GCTACCACCCCAATCACGGCAATGCCACCG
GTCTCGAAATGGGCAGACAGCGACCGCATG|AGGCGTAGGACAGATTGCCGTTAACGAACG
GAGGGCGACAAGTTAACCCCCTGCTACCAC|CCCTTCCTATGTGGTTTGTTTCTATCCTTG
TGTCCGGGAGACAGAGACTTGCCATCAACC|TGCTGATGCTTCGGTAAGTACTGATTGTGA
AATGCCACCGTCTGATTTGCTACAAGTTAA|ACGAGTCCAGACCTAAGTTCTATTTCTGCT
TGAACTTTACGAGATTCACTCCACCAAGTT|AATCAGTCTGCCGGAAGGGAAGTCCCATTA
TAACCCCCTGCTACCACCCCAATCAATTAG|TCGGACCTCGGAGTGCTGCCCAGAACTTGC
TTTACGAGATTCACTCCACCAAGTTAACCC|GTCTGCCGGAAGGGAAGTCCCATTACCGGG
AGTCCAGACCTAAGTTCTATTTCTGCTACA|CACGGCACTTGACGCAAAACACCGCACCGC
AAGTTAACCCCCTGCTACCACCCCCAAGTT|ACAGAGACTTGCCATCAACCTACTATTCCT
GCATGGGCTCGATGTACCCGCTTCTGCGCC|GAACGGCCGGCAAGTTAACCCCCTGCTACC
GAATGAGTCATTACGGGTCGCTAATCTGCG|AAGCCACTCGTCCCTAATATCGCCATTCCC
GCAATGCCACCGTCTGATTTGCTACAAGTT|TCACGAGTCCAGACCTAAGTTCTATTTCTG
TTGCTACAAGTTAACCCCCTGCTACCACCC|GTTCTATTTCTGCTACACAAGTTAACCCCC
CACTCCACCAAGTTAACCCCCTGCTACCAC|GGGAAGTCCCATTACCGGGAGGGCGACAAG
CAAGTTAACCCCCTGCTACCACCCCAATCA|TACCACCCCAATCATTCGCATATCTGTAAT
CAAGTTAACCCCCTGCTACCACCCCAATCA|CCATTACCGGGAGGGCGACAAGTTAACCCC
CCCAATCAGGCACCTCGTTAATCTTTGATT|CCTGCTACCACCCCAATCAAACTGGAAACA
ATCAGTCTGCCGGAAGGGAAGTCCCATTAC|ACCTCGTTAATCTTTGATTAGAGTGAATAG
CGAGTTGTCCGGGAGACAGAGACTTGCCAT|CCTGCTGCTGATGCTTCGGTAAGTACTGAT
GAAGCAAGTTAACCCCCTGCTACCACCCCC|GGGAGACAGAGACTTGCCATCAACCTACTA
TTCGCATATCTGTAATACTATGTAAACTTA|CCTGCTACCACCCCAATCAAATCAGTACTG
AACCCCCTGCTACCACCCCAATCACGGCAA|TTTGTTTCTATCCTTGTCGATAAGCATCAC
CACTTGACGCAAAACACCGCACCGCCAACA|ATGTAAACTTATCAGAACCGCCATCACCCC
CTTCTGCGCCTACAATGAACTTTACGAGAT|CCCTGCTACCACCCCAATCAGTCTGCCGGA
GTTAACGAACGGCCGGCAAGTTAACCCCCT|GATTTGCTACAAGTTAACCCCCTGCTACCA
CCTCGGAGTGCTGCCCAGAACTTGCATATT|AGTCATTACGGGTCGCTAATCTGCGAGTTG
CTGTAATGTACTTGCTCAAGTTAACCCCCT|CGAGTGGCCCAAAACTAATCTGTGGCCCAC
TGGACTGGTTTAGTCTCACATTCTGAATGA|CCAGGTGCGATGTTCGGCTCAAAAAAGCCA
ACCCCAATCAGGCACCTCGTTAATCTTTGA|CCCCTGCTACCACCCCAATCAAACTGGAAA
CCACGCGGCCGGAGTCACTGGGATGACAAC|AAGTTAACCCCCTGCTACCACCCCAATCAT
CCCTGCTACCACCCCAATCATTCGCATATC|TACCACCCCCAAGTTAACCCCCTGCTACCA
AGACTTGCCATCAACCTACTATTCCTTTCC|TAAGTACTGATTGTGAACCCCAGAGTACAA
ATTCTGAATGAGTCATTACGGGTCGCTAAT|CAAAAAAGCCACTCGTCCCTAATATCGCCA
AGTTAACCCCCTGCTACCACCCCCAAGTTA|CAGAGACTTGCCATCAACCTACTATTCCTT
ACAATGAACTTTACGAGATTCACTCCACCA|CCCCAATCAGTCTGCCGGAAGGGAAGTCCC
GTTCTATTTCTGCTACACAAGTTAACCCCC|GCAAAACACCGCACCGCCAACAAGTTAACC
GCCGGAAGGGAAGTCCCATTACCGGGAGGG|AATCTTTGATTAGAGTGAATAGCGCCCCTT
TAACCCCCTGCTACCACCCCAATCACGGGT|GTGGCCCACGTGAACGATGATACATCGAGA
GCGTCTCGAAATGGGCAGACAGCGACCGCA|GGAGGCGTAGGACAGATTGCCGTTAACGAA
ACTGGGATGACAACACCAGGTGCGATGTTC|ACCACCCCAATCATCGGACGACACTATTTG
CCTGCTACCACCCCCAAGTTAACCCCCTGC|GCCATCAACCTACTATTCCTTTCCACGCGG
AGTTAACCCCCTGCTACCACCCCAATCACC|ATTACCGGGAGGGCGACAAGTTAACCCCCT
ATCGCCATTCCCTGCTGCTGATGCTTCGGT|GCAGGTGCTTGCCAGACACTCATAAAGAGG
GGGAAGTCCCATTACCGGGAGGGCGACAAG|GATTAGAGTGAATAGCGCCCCTTCCTATGT
CCGTATCGGACCTCGGAGTGCTGCCCAGAA|ATTCTGAATGAGTCATTACGGGTCGCTAAT
AAACTGGAAACACCGCTTGAGAGCTGAGAG|ATCAATTAGGGGAAATCCAGTGACTCACAA
GTGAACGATGATACATCGAGACCCTCTACC|TAACCCCCTGCTACCACCCCAATCACCCGC
ACCGTCTGATTTGCTACAAGTTAACCCCCT|CCAGACCTAAGTTCTATTTCTGCTACACAA
CTGGGATGACAACACCAGGTGCGATGTTCG|CCACCCCAATCATCGGACGACACTATTTGT
TTCTGAATGAGTCATTACGGGTCGCTAATC|AAAAAAGCCACTCGTCCCTAATATCGCCAT
GAATAGCGCCCCTTCCTATGTGGTTTGTTT|TGAGAGCTGAGAGTCACTTTGAAATGCAAG
CGCTAATCTGCGAGTTGTCCGGGAGACAGA|ATCGCCATTCCCTGCTGCTGATGCTTCGGT
GCATATTCCGGAAGCAAGTTAACCCCCTGC|CGAGTTGTCCGGGAGACAGAGACTTGCCAT
GCTTGAGAGCTGAGAGTCACTTTGAAATGC|ATCCAGTGACTCACAAGTTAACCCCCTGCT
AGTTAACCCCCTGCTACCACCCCAATCACG|TCTGTGGCCCACGTGAACGATGATACATCG
TTAACCCCCTGCTACCACCCCAATCACGGC|GGTTTGTTTCTATCCTTGTCGATAAGCATC
TACCACCCCAATCACGGCACTTGACGCAAA|CGCATATCTGTAATACTATGTAAACTTATC
ACACAAGTTAACCCCCTGCTACCACCCCAA|CGCCAACAAGTTAACCCCCTGCTACCACCC
TGCTACCACCCCAATCACGGCACTTGACGC|ATTCGCATATCTGTAATACTATGTAAACTT
GTTAACCCCCTGCTACCACCCCAATCATTC|CCCCTGCTACCACCCCCAAGTTAACCCCCT
AATCTTTGATTAGAGTGAATAGCGCCCCTT|AACTGGAAACACCGCTTGAGAGCTGAGAGT
CTTGCTCAAGTTAACCCCCTGCTACCACCC|AAAACTAATCTGTGGCCCACGTGAACGATG
GCTCTGGTCTCTGTAATGTACTTGCTCAAG|CTTTGGGACGCGAGTGGCCCAAAACTAATC
CCGGGAGGGCGACAAGTTAACCCCCTGCTA|GCGCCCCTTCCTATGTGGTTTGTTTCTATC
ACAAGTTAACCCCCTGCTACCACCCCAATC|CCCGTATCGGACCTCGGAGTGCTGCCCAGA
ACCCCCTGCTACCACCCAAGTTAACCCCCT|GGCAGTCATGCGTCTCGAAATGGGCAGACA
GACAAGTTAACCCCCTGCTACCACCCCAAT|CTATGTGGTTTGTTTCTATCCTTGTCGATA
TAAGTTCTATTTCTGCTACACAAGTTAACC|GACGCAAAACACCGCACCGCCAACAAGTTA
ATGTACTTGCTCAAGTTAACCCCCTGCTAC|GGCCCAAAACTAATCTGTGGCCCACGTGAA
CCAGACCTAAGTTCTATTTCTGCTACACAA|GGCACTTGACGCAAAACACCGCACCGCCAA
TGCTACACAAGTTAACCCCCTGCTACCACC|GCACCGCCAACAAGTTAACCCCCTGCTACC
AATCACGCTCGGGCTTCGCTAAACTTTCAA|AGTTAACCCCCTGCTACCACCCCAATCACC
CTTGACGCAAAACACCGCACCGCCAACAAG|GTAAACTTATCAGAACCGCCATCACCCCGT
TACTGGACTGGTTTAGTCTCACATTCTGAA|ACACCAGGTGCGATGTTCGGCTCAAAAAAG
TACAATGAACTTTACGAGATTCACTCCACC|ACCCCAATCAGTCTGCCGGAAGGGAAGTCC
AACTTGCATATTCCGGAAGCAAGTTAACCC|ATCTGCGAGTTGTCCGGGAGACAGAGACTT
CCGGCAGTCATGCGTCTCGAAATGGGCAGA|GCTCTTCCCACGGAGGCGTAGGACAGATTG
TTAGTCTCACATTCTGAATGAGTCATTACG|ATGTTCGGCTCAAAAAAGCCACTCGTCCCT
CGGCAAGTTAACCCCCTGCTACCACCCCAA|TTAACCCCCTGCTACCACCCCAATCAGGCA
TACCACCCCAATCACCCGCTCTTCCCACGG|GACAAGTTAACCCCCTGCTACCACCCCAAT
CCGGAGTCACTGGGATGACAACACCAGGTG|CCCCTGCTACCACCCCAATCATCGGACGAC
CCTCGTTAATCTTTGATTAGAGTGAATAGC|CCAATCAAACTGGAAACACCGCTTGAGAGC
TGCCCAGAACTTGCATATTCCGGAAGCAAG|GTCGCTAATCTGCGAGTTGTCCGGGAGACA
TGAGAGCTGAGAGTCACTTTGAAATGCAAG|CAGTGACTCACAAGTTAACCCCCTGCTACC
GCCACTCGTCCCTAATATCGCCATTCCCTG|GGCATTTTGCACTGGTGCAGGTGCTTGCCA
CTCGTTAATCTTTGATTAGAGTGAATAGCG|CAATCAAACTGGAAACACCGCTTGAGAGCT
TTAACCCCCTGCTACCACCCAAGTTAACCC|ACCGGCAGTCATGCGTCTCGAAATGGGCAG
CTGGACTGGTTTAGTCTCACATTCTGAATG|ACCAGGTGCGATGTTCGGCTCAAAAAAGCC
ATTTGCTACAAGTTAACCCCCTGCTACCAC|AAGTTCTATTTCTGCTACACAAGTTAACCC
GAGTGAATAGCGCCCCTTCCTATGTGGTTT|CGCTTGAGAGCTGAGAGTCACTTTGAAATG
ACAAGTTAACCCCCTGCTACCACCCAAGTT|CCTCTACCGGCAGTCATGCGTCTCGAAATG
CAATCAATTAGGGGAAATCCAGTGACTCAC|CCAGAACTTGCATATTCCGGAAGCAAGTTA
AAGTTAACCCCCTGCTACCACCCAAGTTAA|TCTACCGGCAGTCATGCGTCTCGAAATGGG
TCTCTGTAATGTACTTGCTCAAGTTAACCC|ACGCGAGTGGCCCAAAACTAATCTGTGGCC
ATTTCTGCTACACAAGTTAACCCCCTGCTA|ACACCGCACCGCCAACAAGTTAACCCCCTG
CCCAATCACGGCACTTGACGCAAAACACCG|TCTGTAATACTATGTAAACTTATCAGAACC
TAACCCCCTGCTACCACCCCAATCACCCGC|ACCGGGAGGGCGACAAGTTAACCCCCTGCT
AATAGACTGAACAGCGTGGCCGTCCCAAGT|CTGCTACCACCCCAATCACGGGTGACAAGT
TGAGTCATTACGGGTCGCTAATCTGCGAGT|CCACTCGTCCCTAATATCGCCATTCCCTGC
CTAAACTTTCAAGGCTGAACGTCTGCTCTG|ACCCCAATCACCAATCATTTCGTACTTTGG
GTCTGATTTGCTACAAGTTAACCCCCTGCT|GACCTAAGTTCTATTTCTGCTACACAAGTT
GTTAACCCCCTGCTACCACCCCAATCAAAC|CAAGTTAACCCCCTGCTACCACCCCAATCA
GAACGGCCGGCAAGTTAACCCCCTGCTACC|CTACAAGTTAACCCCCTGCTACCACCCCAA
ACCTAAGTTCTATTTCTGCTACACAAGTTA|CTTGACGCAAAACACCGCACCGCCAACAAG
ATAGACTGAACAGCGTGGCCGTCCCAAGTT|TGCTACCACCCCAATCACGGGTGACAAGTT
CCCTTCCTATGTGGTTTGTTTCTATCCTTG|AGAGTCACTTTGAAATGCAAGTTAACCCCC
GACCTAAGTTCTATTTCTGCTACACAAGTT|ACTTGACGCAAAACACCGCACCGCCAACAA
CCCTGCTACCACCCCAATCAAATCAGTACT|ACGCGGCCGGAGTCACTGGGATGACAACAC
GCTACCACCCCAATCATTCGCATATCTGTA|ACCCCCAAGTTAACCCCCTGCTACCACCCC
CGGCCGGCAAGTTAACCCCCTGCTACCACC|CAAGTTAACCCCCTGCTACCACCCCAATCA
TACCGGCAGTCATGCGTCTCGAAATGGGCA|CCGCTCTTCCCACGGAGGCGTAGGACAGAT
GAGACCCTCTACCGGCAGTCATGCGTCTCG|CCCAATCACCCGCTCTTCCCACGGAGGCGT
ATTGCCGTTAACGAACGGCCGGCAAGTTAA|CCGTCTGATTTGCTACAAGTTAACCCCCTG
CACCAATCATTTCGTACTTTGGGACGCGAG|TCGATGTACCCGCTTCTGCGCCTACAATGA
GCCCACGTGAACGATGATACATCGAGACCC|CCAAGTTAACCCCCTGCTACCACCCCAATC
AATCTGTGGCCCACGTGAACGATGATACAT|TCACTCCACCAAGTTAACCCCCTGCTACCA
CTCTGTAATGTACTTGCTCAAGTTAACCCC|CGCGAGTGGCCCAAAACTAATCTGTGGCCC
CACGCTCGGGCTTCGCTAAACTTTCAAGGC|TAACCCCCTGCTACCACCCCAATCACCAAT
TGCTACCACCCCAATCAGGCACCTCGTTAA|AGTTAACCCCCTGCTACCACCCCAATCAAA
CACCCAAGTTAACCCCCTGCTACCACCCCA|TCTCGAAATGGGCAGACAGCGACCGCATGG
CCCAATCAATTAGGGGAAATCCAGTGACTC|GCCCAGAACTTGCATATTCCGGAAGCAAGT
TTAACCCCCTGCTACCACCCCAATCACGGC|ACCCCAATCATTCGCATATCTGTAATACTA
TGCTCAAGTTAACCCCCTGCTACCACCCCA|AACTAATCTGTGGCCCACGTGAACGATGAT
GCGACAAGTTAACCCCCTGCTACCACCCCA|TCCTATGTGGTTTGTTTCTATCCTTGTCGA
ACGCGAGTGGCCCAAAACTAATCTGTGGCC|ACAATGAACTTTACGAGATTCACTCCACCA
TAACCCCCTGCTACCACCCAAGTTAACCCC|CCGGCAGTCATGCGTCTCGAAATGGGCAGA
GTACTTTGGGACGCGAGTGGCCCAAAACTA|TTCTGCGCCTACAATGAACTTTACGAGATT
GAGAGTCACTTTGAAATGCAAGTTAACCCC|CACAAGTTAACCCCCTGCTACCACCCCAAT
ATCACGGGTGACAAGTTAACCCCCTGCTAC|ACATCGAGACCCTCTACCGGCAGTCATGCG
TACGAGATTCACTCCACCAAGTTAACCCCC|CTGCCGGAAGGGAAGTCCCATTACCGGGAG
TTTGGGACGCGAGTGGCCCAAAACTAATCT|GCGCCTACAATGAACTTTACGAGATTCACT
ATACATCGAGACCCTCTACCGGCAGTCATG|CTACCACCCCAATCACCCGCTCTTCCCACG
ACCACCCCAATCAGTCTGCCGGAAGGGAAG|CAATCAGGCACCTCGTTAATCTTTGATTAG
GCTACCACCCCAATCACGCTCGGGCTTCGC|GCTACCACCCAAGTTAACCCCCTGCTACCA
GGACTGGTTTAGTCTCACATTCTGAATGAG|CAGGTGCGATGTTCGGCTCAAAAAAGCCAC
CACCCCGTATCGGACCTCGGAGTGCTGCCC|TCACATTCTGAATGAGTCATTACGGGTCGC
GGTGCGATGTTCGGCTCAAAAAAGCCACTC|CGACACTATTTGTGCCAGTACTTGGCATTT
GCCATTCCCTGCTGCTGATGCTTCGGTAAG|GGTGCTTGCCAGACACTCATAAAGAGGATG
CAATCACCCGCTCTTCCCACGGAGGCGTAG|AACCCCCTGCTACCACCCCAATCACGGCAA
CCTGCTACCACCCCAATCAAATCAGTACTG|CGCGGCCGGAGTCACTGGGATGACAACACC
CCCATTACCGGGAGGGCGACAAGTTAACCC|GTGAATAGCGCCCCTTCCTATGTGGTTTGT
CCCTGCTACCACCCCAATCACGCTCGGGCT|CCCTGCTACCACCCAAGTTAACCCCCTGCT
CAATCACCAATCATTTCGTACTTTGGGACG|GGGCTCGATGTACCCGCTTCTGCGCCTACA
CCCAATCAGTCTGCCGGAAGGGAAGTCCCA|AGGCACCTCGTTAATCTTTGATTAGAGTGA
CTGCTACCACCCCAATCAAATCAGTACTGG|GCGGCCGGAGTCACTGGGATGACAACACCA
ACCGCCATCACCCCGTATCGGACCTCGGAG|GTTTAGTCTCACATTCTGAATGAGTCATTA
CACCGTCTGATTTGCTACAAGTTAACCCCC|TCCAGACCTAAGTTCTATTTCTGCTACACA
TCCACCAAGTTAACCCCCTGCTACCACCCC|AAGTCCCATTACCGGGAGGGCGACAAGTTA
ATTACCGGGAGGGCGACAAGTTAACCCCCT|AATAGCGCCCCTTCCTATGTGGTTTGTTTC
CAAGTTAACCCCCTGCTACCACCCCAATCA|CAAGTTAACCCCCTGCTACCACCCAAGTTA
CTATTTCTGCTACACAAGTTAACCCCCTGC|AAACACCGCACCGCCAACAAGTTAACCCCC
TCAAGTTAACCCCCTGCTACCACCCCAATC|TAATCTGTGGCCCACGTGAACGATGATACA
AAATAGACTGAACAGCGTGGCCGTCCCAAG|CCTGCTACCACCCCAATCACGGGTGACAAG
CCAATCACGGGTGACAAGTTAACCCCCTGC|GATACATCGAGACCCTCTACCGGCAGTCAT
GAGACAGAGACTTGCCATCAACCTACTATT|GCTTCGGTAAGTACTGATTGTGAACCCCAG
CTACCACCCCAATCACGGCAATGCCACCGT|ATCCTTGTCGATAAGCATCACGAGTCCAGA
AAAACACCGCACCGCCAACAAGTTAACCCC|ATCAGAACCGCCATCACCCCGTATCGGACC
CACCCCCAAGTTAACCCCCTGCTACCACCC|CCTACTATTCCTTTCCACGCGGCCGGAGTC
ATGAACTTTACGAGATTCACTCCACCAAGT|CAATCAGTCTGCCGGAAGGGAAGTCCCATT
AGTGGCCCAAAACTAATCTGTGGCCCACGT|GAACTTTACGAGATTCACTCCACCAAGTTA
CACCGCTTGAGAGCTGAGAGTCACTTTGAA|GGAAATCCAGTGACTCACAAGTTAACCCCC
TCTGCGAGTTGTCCGGGAGACAGAGACTTG|ATTCCCTGCTGCTGATGCTTCGGTAAGTAC
AGACAGAGACTTGCCATCAACCTACTATTC|CTTCGGTAAGTACTGATTGTGAACCCCAGA
GAGTCACTGGGATGACAACACCAGGTGCGA|CTGCTACCACCCCAATCATCGGACGACACT
CCAATCAAACTGGAAACACCGCTTGAGAGC|ACCCCAATCAATTAGGGGAAATCCAGTGAC
ACGTGAACGATGATACATCGAGACCCTCTA|GTTAACCCCCTGCTACCACCCCAATCACCC
GGACGCGAGTGGCCCAAAACTAATCTGTGG|CTACAATGAACTTTACGAGATTCACTCCAC
CAATCAGTCTGCCGGAAGGGAAGTCCCATT|GCACCTCGTTAATCTTTGATTAGAGTGAAT
AACACCGCTTGAGAGCTGAGAGTCACTTTG|GGGGAAATCCAGTGACTCACAAGTTAACCC
CCAATCACGGCAATGCCACCGTCTGATTTG|CGATAAGCATCACGAGTCCAGACCTAAGTT
ATTAGGGGAAATCCAGTGACTCACAAGTTA|CTTGCATATTCCGGAAGCAAGTTAACCCCC
CATCGAGACCCTCTACCGGCAGTCATGCGT|CCACCCCAATCACCCGCTCTTCCCACGGAG
CAAAACTAATCTGTGGCCCACGTGAACGAT|ACGAGATTCACTCCACCAAGTTAACCCCCT
TGGCCCACGTGAACGATGATACATCGAGAC|CACCAAGTTAACCCCCTGCTACCACCCCAA
CTGCTCTGGTCTCTGTAATGTACTTGCTCA|TACTTTGGGACGCGAGTGGCCCAAAACTAA
ACTCCACCAAGTTAACCCCCTGCTACCACC|GGAAGTCCCATTACCGGGAGGGCGACAAGT
CTTTGGGACGCGAGTGGCCCAAAACTAATC|TGCGCCTACAATGAACTTTACGAGATTCAC
AAACTTTCAAGGCTGAACGTCTGCTCTGGT|CCCAATCACCAATCATTTCGTACTTTGGGA
TTCTGCTACACAAGTTAACCCCCTGCTACC|ACCGCACCGCCAACAAGTTAACCCCCTGCT
CCCCTGCTACCACCCCAATCACGGCAATGC|GTTTCTATCCTTGTCGATAAGCATCACGAG
AACCCCCTGCTACCACCCCAATCACGGGTG|TGGCCCACGTGAACGATGATACATCGAGAC
ACTTATCAGAACCGCCATCACCCCGTATCG|TACTGGACTGGTTTAGTCTCACATTCTGAA
AACTAATCTGTGGCCCACGTGAACGATGAT|AGATTCACTCCACCAAGTTAACCCCCTGCT
CAGCGACCGCATGGGCTCGATGTACCCGCT|CCGTTAACGAACGGCCGGCAAGTTAACCCC
ACCACCCCAATCACCCGCTCTTCCCACGGA|ACAAGTTAACCCCCTGCTACCACCCCAATC
AGGCGTAGGACAGATTGCCGTTAACGAACG|CACGGCAATGCCACCGTCTGATTTGCTACA
GCGGCCGGAGTCACTGGGATGACAACACCA|TAACCCCCTGCTACCACCCCAATCATCGGA
CGTTAACGAACGGCCGGCAAGTTAACCCCC|TGATTTGCTACAAGTTAACCCCCTGCTACC
TGTTCGGCTCAAAAAAGCCACTCGTCCCTA|ATTTGTGCCAGTACTTGGCATTTTGCACTG
ACCACCCCAATCAATTAGGGGAAATCCAGT|GTGCTGCCCAGAACTTGCATATTCCGGAAG
CCTACAATGAACTTTACGAGATTCACTCCA|CCACCCCAATCAGTCTGCCGGAAGGGAAGT
GGGCTTCGCTAAACTTTCAAGGCTGAACGT|CTGCTACCACCCCAATCACCAATCATTTCG
TGGGATGACAACACCAGGTGCGATGTTCGG|CACCCCAATCATCGGACGACACTATTTGTG
TACCACCCCAATCACGGGTGACAAGTTAAC|GAACGATGATACATCGAGACCCTCTACCGG
GATTCACTCCACCAAGTTAACCCCCTGCTA|GGAAGGGAAGTCCCATTACCGGGAGGGCGA
TGGGCAGACAGCGACCGCATGGGCTCGATG|ACAGATTGCCGTTAACGAACGGCCGGCAAG
CTGCTACCACCCCAATCACCCGCTCTTCCC|GGGCGACAAGTTAACCCCCTGCTACCACCC
ACAACACCAGGTGCGATGTTCGGCTCAAAA|ATCATCGGACGACACTATTTGTGCCAGTAC
CACCGCACCGCCAACAAGTTAACCCCCTGC|GAACCGCCATCACCCCGTATCGGACCTCGG
CCCCCTGCTACCACCCCAATCAGGCACCTC|ACACAAGTTAACCCCCTGCTACCACCCCAA
CGGCAATGCCACCGTCTGATTTGCTACAAG|CATCACGAGTCCAGACCTAAGTTCTATTTC
CCGGCAAGTTAACCCCCTGCTACCACCCCA|GTTAACCCCCTGCTACCACCCCAATCAGGC
GATTGCCGTTAACGAACGGCCGGCAAGTTA|ACCGTCTGATTTGCTACAAGTTAACCCCCT
GCGATGTTCGGCTCAAAAAAGCCACTCGTC|CACTATTTGTGCCAGTACTTGGCATTTTGC
GGCTTCGCTAAACTTTCAAGGCTGAACGTC|TGCTACCACCCCAATCACCAATCATTTCGT
ATCACCCCGTATCGGACCTCGGAGTGCTGC|TCTCACATTCTGAATGAGTCATTACGGGTC
ACCACCCCAATCATTCGCATATCTGTAATA|CCCAAGTTAACCCCCTGCTACCACCCCAAT
CATATCTGTAATACTATGTAAACTTATCAG|CTACCACCCCAATCAAATCAGTACTGGACT
GGCCGTCCCAAGTTAACCCCCTGCTACCAC|ACGGGTGACAAGTTAACCCCCTGCTACCAC
GCCAACAAGTTAACCCCCTGCTACCACCCC|TCACCCCGTATCGGACCTCGGAGTGCTGCC
CCGGAAGCAAGTTAACCCCCTGCTACCACC|TCCGGGAGACAGAGACTTGCCATCAACCTA
TGCTACCACCCCAATCAAACTGGAAACACC|CCCTGCTACCACCCCAATCAATTAGGGGAA
CCCAATCACGCTCGGGCTTCGCTAAACTTT|CCAAGTTAACCCCCTGCTACCACCCCAATC
TCCAGTGACTCACAAGTTAACCCCCTGCTA|CGGAAGCAAGTTAACCCCCTGCTACCACCC
CGTATCGGACCTCGGAGTGCTGCCCAGAAC|TTCTGAATGAGTCATTACGGGTCGCTAATC
AGAACCGCCATCACCCCGTATCGGACCTCG|CTGGTTTAGTCTCACATTCTGAATGAGTCA
GCCCAGAACTTGCATATTCCGGAAGCAAGT|TCGCTAATCTGCGAGTTGTCCGGGAGACAG
AAAGCCACTCGTCCCTAATATCGCCATTCC|CTTGGCATTTTGCACTGGTGCAGGTGCTTG
AAGTTAACCCCCTGCTACCACCCCAATCAC|AAGTTAACCCCCTGCTACCACCCAAGTTAA
GGAGACAGAGACTTGCCATCAACCTACTAT|TGCTTCGGTAAGTACTGATTGTGAACCCCA
CACGGCACTTGACGCAAAACACCGCACCGC|ATACTATGTAAACTTATCAGAACCGCCATC
GTTGTCCGGGAGACAGAGACTTGCCATCAA|GCTGCTGATGCTTCGGTAAGTACTGATTGT
GTGAATAGCGCCCCTTCCTATGTGGTTTGT|CTTGAGAGCTGAGAGTCACTTTGAAATGCA
AAATCAGTACTGGACTGGTTTAGTCTCACA|GATGACAACACCAGGTGCGATGTTCGGCTC
CTTTCAAGGCTGAACGTCTGCTCTGGTCTC|AATCACCAATCATTTCGTACTTTGGGACGC
TCTGGTCTCTGTAATGTACTTGCTCAAGTT|TTGGGACGCGAGTGGCCCAAAACTAATCTG
AAATCCAGTGACTCACAAGTTAACCCCCTG|TTCCGGAAGCAAGTTAACCCCCTGCTACCA
ACCCCAATCAAATCAGTACTGGACTGGTTT|AGTCACTGGGATGACAACACCAGGTGCGAT
GAGCAGAAATAGACTGAACAGCGTGGCCGT|TAACCCCCTGCTACCACCCCAATCACGGGT
AATACTATGTAAACTTATCAGAACCGCCAT|CAATCAAATCAGTACTGGACTGGTTTAGTC
TACCACCCCAATCAGTCTGCCGGAAGGGAA|CCAATCAGGCACCTCGTTAATCTTTGATTA
TCTGAATGAGTCATTACGGGTCGCTAATCT|AAAAAGCCACTCGTCCCTAATATCGCCATT
CCCTAATATCGCCATTCCCTGCTGCTGATG|CACTGGTGCAGGTGCTTGCCAGACACTCAT
ATTCACTCCACCAAGTTAACCCCCTGCTAC|GAAGGGAAGTCCCATTACCGGGAGGGCGAC
CTACCACCCCAATCAATTAGGGGAAATCCA|GAGTGCTGCCCAGAACTTGCATATTCCGGA
CCAATCACGGCACTTGACGCAAAACACCGC|CTGTAATACTATGTAAACTTATCAGAACCG
GCTACCACCCCAATCAGTCTGCCGGAAGGG|CCCCAATCAGGCACCTCGTTAATCTTTGAT
ATCAGAACCGCCATCACCCCGTATCGGACC|GGACTGGTTTAGTCTCACATTCTGAATGAG
CCGGGAGACAGAGACTTGCCATCAACCTAC|TGATGCTTCGGTAAGTACTGATTGTGAACC
ATACTATGTAAACTTATCAGAACCGCCATC|AATCAAATCAGTACTGGACTGGTTTAGTCT
CTCTGGTCTCTGTAATGTACTTGCTCAAGT|TTTGGGACGCGAGTGGCCCAAAACTAATCT
ATCAAACTGGAAACACCGCTTGAGAGCTGA|CCAATCAATTAGGGGAAATCCAGTGACTCA
GTTAACCCCCTGCTACCACCCCAATCAAAT|CCTTTCCACGCGGCCGGAGTCACTGGGATG
CTCGGAGTGCTGCCCAGAACTTGCATATTC|GTCATTACGGGTCGCTAATCTGCGAGTTGT
TCATGCGTCTCGAAATGGGCAGACAGCGAC|CCACGGAGGCGTAGGACAGATTGCCGTTAA
CTACCACCCCAATCAAATCAGTACTGGACT|GCCGGAGTCACTGGGATGACAACACCAGGT
ATCTTTGATTAGAGTGAATAGCGCCCCTTC|ACTGGAAACACCGCTTGAGAGCTGAGAGTC
GTTAACCCCCTGCTACCACCCCAATCACCC|TTACCGGGAGGGCGACAAGTTAACCCCCTG
AGTTAACCCCCTGCTACCACCCCAATCACG|CCACCCCAATCATTCGCATATCTGTAATAC
GCGTGGCCGTCCCAAGTTAACCCCCTGCTA|AATCACGGGTGACAAGTTAACCCCCTGCTA
GGGCGACAAGTTAACCCCCTGCTACCACCC|CTTCCTATGTGGTTTGTTTCTATCCTTGTC
CGCACCGCCAACAAGTTAACCCCCTGCTAC|CCGCCATCACCCCGTATCGGACCTCGGAGT
TCACCCGCTCTTCCCACGGAGGCGTAGGAC|CCCCTGCTACCACCCCAATCACGGCAATGC
CCAATCACCAATCATTTCGTACTTTGGGAC|TGGGCTCGATGTACCCGCTTCTGCGCCTAC
ACAAGTTAACCCCCTGCTACCACCCCAATC|CCAACAAGTTAACCCCCTGCTACCACCCCA
CTGAGAGTCACTTTGAAATGCAAGTTAACC|CTCACAAGTTAACCCCCTGCTACCACCCCA
CCCCTGCTACCACCCCAATCAAACTGGAAA|AACCCCCTGCTACCACCCCAATCAATTAGG
ACCCCCTGCTACCACCCCAATCAAATCAGT|TCCACGCGGCCGGAGTCACTGGGATGACAA
TCCGGGAGACAGAGACTTGCCATCAACCTA|CTGATGCTTCGGTAAGTACTGATTGTGAAC
TTCTGCGCCTACAATGAACTTTACGAGATT|CCTGCTACCACCCCAATCAGTCTGCCGGAA
ACCACCCCCAAGTTAACCCCCTGCTACCAC|AACCTACTATTCCTTTCCACGCGGCCGGAG
CCCCAATCACGCTCGGGCTTCGCTAAACTT|CCCAAGTTAACCCCCTGCTACCACCCCAAT
GTCTGCCGGAAGGGAAGTCCCATTACCGGG|CGTTAATCTTTGATTAGAGTGAATAGCGCC
ACCAGGTGCGATGTTCGGCTCAAAAAAGCC|CGGACGACACTATTTGTGCCAGTACTTGGC
ACTGGACTGGTTTAGTCTCACATTCTGAAT|CACCAGGTGCGATGTTCGGCTCAAAAAAGC
AGATTGCCGTTAACGAACGGCCGGCAAGTT|CACCGTCTGATTTGCTACAAGTTAACCCCC
AACCCCCTGCTACCACCCCAATCAGGCACC|CTACACAAGTTAACCCCCTGCTACCACCCC
TAAACTTATCAGAACCGCCATCACCCCGTA|CAGTACTGGACTGGTTTAGTCTCACATTCT
TGACTCACAAGTTAACCCCCTGCTACCACC|GCAAGTTAACCCCCTGCTACCACCCCCAAG
GTCCCAAGTTAACCCCCTGCTACCACCCCA|GTGACAAGTTAACCCCCTGCTACCACCCAA
CGGGTCGCTAATCTGCGAGTTGTCCGGGAG|CTAATATCGCCATTCCCTGCTGCTGATGCT
CATTCGCATATCTGTAATACTATGTAAACT|CCCCTGCTACCACCCCAATCAAATCAGTAC
CCCAAGTTAACCCCCTGCTACCACCCCAAT|TCGAAATGGGCAGACAGCGACCGCATGGGC
CCCCAATCAGTCTGCCGGAAGGGAAGTCCC|CAGGCACCTCGTTAATCTTTGATTAGAGTG
GAGTTGTCCGGGAGACAGAGACTTGCCATC|CTGCTGCTGATGCTTCGGTAAGTACTGATT
AAGCAAGTTAACCCCCTGCTACCACCCCCA|GGAGACAGAGACTTGCCATCAACCTACTAT
TGGTTTAGTCTCACATTCTGAATGAGTCAT|TGCGATGTTCGGCTCAAAAAAGCCACTCGT
GCAAGTTAACCCCCTGCTACCACCCCAATC|AACCCCCTGCTACCACCCCAATCAGGCACC
CTTCGCTAAACTTTCAAGGCTGAACGTCTG|CTACCACCCCAATCACCAATCATTTCGTAC
CATCAACCTACTATTCCTTTCCACGCGGCC|GATTGTGAACCCCAGAGTACAAGTTAACCC
TCAAGGCTGAACGTCTGCTCTGGTCTCTGT|CACCAATCATTTCGTACTTTGGGACGCGAG
CACCCCAATCACGGCAATGCCACCGTCTGA|TTGTCGATAAGCATCACGAGTCCAGACCTA
CCTGCTACCACCCCAATCACGGCAATGCCA|TTCTATCCTTGTCGATAAGCATCACGAGTC
AATCACGGCACTTGACGCAAAACACCGCAC|GTAATACTATGTAAACTTATCAGAACCGCC
TTTGCTACAAGTTAACCCCCTGCTACCACC|AGTTCTATTTCTGCTACACAAGTTAACCCC
CCCCTTCCTATGTGGTTTGTTTCTATCCTT|GAGAGTCACTTTGAAATGCAAGTTAACCCC
GTTAACCCCCTGCTACCACCCCAATCAATT|TATCGGACCTCGGAGTGCTGCCCAGAACTT
CCCGCTTCTGCGCCTACAATGAACTTTACG|AACCCCCTGCTACCACCCCAATCAGTCTGC
CACCCCAATCAATTAGGGGAAATCCAGTGA|GCTGCCCAGAACTTGCATATTCCGGAAGCA
ACCCCCTGCTACCACCCCAATCACCAATCA|GCAGACAGCGACCGCATGGGCTCGATGTAC
CAATGAACTTTACGAGATTCACTCCACCAA|CCCAATCAGTCTGCCGGAAGGGAAGTCCCA
CAAGTTAACCCCCTGCTACCACCCCAATCA|GAAATGGGCAGACAGCGACCGCATGGGCTC
GAAATCCAGTGACTCACAAGTTAACCCCCT|ATTCCGGAAGCAAGTTAACCCCCTGCTACC
CTGTGGCCCACGTGAACGATGATACATCGA|CTCCACCAAGTTAACCCCCTGCTACCACCC
TCATTACGGGTCGCTAATCTGCGAGTTGTC|TCGTCCCTAATATCGCCATTCCCTGCTGCT
ACCCCCTGCTACCACCCCAATCAATTAGGG|GGACCTCGGAGTGCTGCCCAGAACTTGCAT
ACATCGAGACCCTCTACCGGCAGTCATGCG|ACCACCCCAATCACCCGCTCTTCCCACGGA
ATGCAAGTTAACCCCCTGCTACCACCCCAA|TGCTACCACCCCAATCATTCGCATATCTGT
TATCGCCATTCCCTGCTGCTGATGCTTCGG|TGCAGGTGCTTGCCAGACACTCATAAAGAG
AACGTCTGCTCTGGTCTCTGTAATGTACTT|TTTCGTACTTTGGGACGCGAGTGGCCCAAA
AACGGCCGGCAAGTTAACCCCCTGCTACCA|TACAAGTTAACCCCCTGCTACCACCCCAAT
TCAACCTACTATTCCTTTCCACGCGGCCGG|TTGTGAACCCCAGAGTACAAGTTAACCCCC
AACCCCCTGCTACCACCCCAATCAATTAGG|CGGACCTCGGAGTGCTGCCCAGAACTTGCA
CCTTGTCGATAAGCATCACGAGTCCAGACC|CCCCCTGCTACCACCCCAATCACGGCACTT
CCCCAATCACGGCAATGCCACCGTCTGATT|GTCGATAAGCATCACGAGTCCAGACCTAAG
ATCCTTGTCGATAAGCATCACGAGTCCAGA|AACCCCCTGCTACCACCCCAATCACGGCAC
CATCACCCCGTATCGGACCTCGGAGTGCTG|GTCTCACATTCTGAATGAGTCATTACGGGT
ACTATTCCTTTCCACGCGGCCGGAGTCACT|CCCCAGAGTACAAGTTAACCCCCTGCTACC
GACAGAGACTTGCCATCAACCTACTATTCC|TTCGGTAAGTACTGATTGTGAACCCCAGAG
TCACGGCAATGCCACCGTCTGATTTGCTAC|AAGCATCACGAGTCCAGACCTAAGTTCTAT
ACTTTACGAGATTCACTCCACCAAGTTAAC|CAGTCTGCCGGAAGGGAAGTCCCATTACCG
AACCCCCTGCTACCACCCCAATCAGTCTGC|TGCTACCACCCCAATCAGGCACCTCGTTAA
CCCTGCTACCACCCCAATCACCAATCATTT|GACAGCGACCGCATGGGCTCGATGTACCCG
CGGCACTTGACGCAAAACACCGCACCGCCA|ACTATGTAAACTTATCAGAACCGCCATCAC
CTGAACGTCTGCTCTGGTCTCTGTAATGTA|TCATTTCGTACTTTGGGACGCGAGTGGCCC
CTTGTCGATAAGCATCACGAGTCCAGACCT|CCCCTGCTACCACCCCAATCACGGCACTTG
CACCTCGTTAATCTTTGATTAGAGTGAATA|CCCCAATCAAACTGGAAACACCGCTTGAGA
ACCCCCTGCTACCACCCCAATCATTCGCAT|TGCTACCACCCCCAAGTTAACCCCCTGCTA
CACGGCAATGCCACCGTCTGATTTGCTACA|AGCATCACGAGTCCAGACCTAAGTTCTATT
CGTGGCCGTCCCAAGTTAACCCCCTGCTAC|ATCACGGGTGACAAGTTAACCCCCTGCTAC
AAGTTAACCCCCTGCTACCACCCCAATCAA|AACAAGTTAACCCCCTGCTACCACCCCAAT
TCACCCCGTATCGGACCTCGGAGTGCTGCC|CTCACATTCTGAATGAGTCATTACGGGTCG
TACCACCCCAATCACGCTCGGGCTTCGCTA|TACCACCCAAGTTAACCCCCTGCTACCACC
GGCAGACAGCGACCGCATGGGCTCGATGTA|AGATTGCCGTTAACGAACGGCCGGCAAGTT
AAAAGCCACTCGTCCCTAATATCGCCATTC|ACTTGGCATTTTGCACTGGTGCAGGTGCTT
CGATGTACCCGCTTCTGCGCCTACAATGAA|GCAAGTTAACCCCCTGCTACCACCCCAATC
CTTGCCATCAACCTACTATTCCTTTCCACG|GTACTGATTGTGAACCCCAGAGTACAAGTT
ACCGGCAGTCATGCGTCTCGAAATGGGCAG|CGCTCTTCCCACGGAGGCGTAGGACAGATT
ACTTGCATATTCCGGAAGCAAGTTAACCCC|TCTGCGAGTTGTCCGGGAGACAGAGACTTG
TACCACCCCAATCAGGCACCTCGTTAATCT|TAACCCCCTGCTACCACCCCAATCAAACTG
TCACTTTGAAATGCAAGTTAACCCCCTGCT|GTTAACCCCCTGCTACCACCCCAATCATTC
CGCTTGAGAGCTGAGAGTCACTTTGAAATG|AATCCAGTGACTCACAAGTTAACCCCCTGC
CCCCAATCAATTAGGGGAAATCCAGTGACT|TGCCCAGAACTTGCATATTCCGGAAGCAAG
ACCCCCTGCTACCACCCCCAAGTTAACCCC|ACTTGCCATCAACCTACTATTCCTTTCCAC
CCACCCCCAAGTTAACCCCCTGCTACCACC|ACCTACTATTCCTTTCCACGCGGCCGGAGT
CCACCCCAATCACGGCAATGCCACCGTCTG|CTTGTCGATAAGCATCACGAGTCCAGACCT
ATTTCGTACTTTGGGACGCGAGTGGCCCAA|CCCGCTTCTGCGCCTACAATGAACTTTACG
GCTCAAAAAAGCCACTCGTCCCTAATATCG|GCCAGTACTTGGCATTTTGCACTGGTGCAG
ACCCCAATCAAACTGGAAACACCGCTTGAG|ACCACCCCAATCAATTAGGGGAAATCCAGT
TCGAAATGGGCAGACAGCGACCGCATGGGC|CGTAGGACAGATTGCCGTTAACGAACGGCC
GCTGCCCAGAACTTGCATATTCCGGAAGCA|GGGTCGCTAATCTGCGAGTTGTCCGGGAGA
AGGCACCTCGTTAATCTTTGATTAGAGTGA|CCACCCCAATCAAACTGGAAACACCGCTTG
GTTAACCCCCTGCTACCACCCCAATCAGGC|CTGCTACACAAGTTAACCCCCTGCTACCAC
GCACCGCCAACAAGTTAACCCCCTGCTACC|CGCCATCACCCCGTATCGGACCTCGGAGTG
CTATTCCTTTCCACGCGGCCGGAGTCACTG|CCCAGAGTACAAGTTAACCCCCTGCTACCA
AACCTACTATTCCTTTCCACGCGGCCGGAG|GTGAACCCCAGAGTACAAGTTAACCCCCTG
AGTGCTGCCCAGAACTTGCATATTCCGGAA|TACGGGTCGCTAATCTGCGAGTTGTCCGGG
CCCCAATCATTCGCATATCTGTAATACTAT|AGTTAACCCCCTGCTACCACCCCAATCAAA
ACCCCCTGCTACCACCCCAATCAGGCACCT|TACACAAGTTAACCCCCTGCTACCACCCCA
AAGTTCTATTTCTGCTACACAAGTTAACCC|ACGCAAAACACCGCACCGCCAACAAGTTAA
GAGTGCTGCCCAGAACTTGCATATTCCGGA|TTACGGGTCGCTAATCTGCGAGTTGTCCGG
CTTTGATTAGAGTGAATAGCGCCCCTTCCT|TGGAAACACCGCTTGAGAGCTGAGAGTCAC
GGGAGGGCGACAAGTTAACCCCCTGCTACC|GCCCCTTCCTATGTGGTTTGTTTCTATCCT
ACGTCTGCTCTGGTCTCTGTAATGTACTTG|TTCGTACTTTGGGACGCGAGTGGCCCAAAA
ACCCTCTACCGGCAGTCATGCGTCTCGAAA|AATCACCCGCTCTTCCCACGGAGGCGTAGG
CGCCATCACCCCGTATCGGACCTCGGAGTG|TTAGTCTCACATTCTGAATGAGTCATTACG
TCCCATTACCGGGAGGGCGACAAGTTAACC|AGTGAATAGCGCCCCTTCCTATGTGGTTTG
GGCCGGCAAGTTAACCCCCTGCTACCACCC|AAGTTAACCCCCTGCTACCACCCCAATCAG
ACCCCAATCACCCGCTCTTCCCACGGAGGC|AGTTAACCCCCTGCTACCACCCCAATCACG
GAGAGCTGAGAGTCACTTTGAAATGCAAGT|AGTGACTCACAAGTTAACCCCCTGCTACCA
CACGGGTGACAAGTTAACCCCCTGCTACCA|ATCGAGACCCTCTACCGGCAGTCATGCGTC
AATGGGCAGACAGCGACCGCATGGGCTCGA|GGACAGATTGCCGTTAACGAACGGCCGGCA
ATCATTTCGTACTTTGGGACGCGAGTGGCC|GTACCCGCTTCTGCGCCTACAATGAACTTT
TTCCCACGGAGGCGTAGGACAGATTGCCGT|CACCCCAATCACGGCAATGCCACCGTCTGA
CATGCGTCTCGAAATGGGCAGACAGCGACC|CACGGAGGCGTAGGACAGATTGCCGTTAAC
GGGAAATCCAGTGACTCACAAGTTAACCCC|ATATTCCGGAAGCAAGTTAACCCCCTGCTA
AGAGACTTGCCATCAACCTACTATTCCTTT|GGTAAGTACTGATTGTGAACCCCAGAGTAC
CCATTCCCTGCTGCTGATGCTTCGGTAAGT|GTGCTTGCCAGACACTCATAAAGAGGATGG
TGCTCTGGTCTCTGTAATGTACTTGCTCAA|ACTTTGGGACGCGAGTGGCCCAAAACTAAT
TCGATGTACCCGCTTCTGCGCCTACAATGA|GGCAAGTTAACCCCCTGCTACCACCCCAAT
CGGAGGCGTAGGACAGATTGCCGTTAACGA|AATCACGGCAATGCCACCGTCTGATTTGCT
GAACTTTACGAGATTCACTCCACCAAGTTA|ATCAGTCTGCCGGAAGGGAAGTCCCATTAC
CCACCCCAATCAAATCAGTACTGGACTGGT|GGAGTCACTGGGATGACAACACCAGGTGCG
CGGCTCAAAAAAGCCACTCGTCCCTAATAT|GTGCCAGTACTTGGCATTTTGCACTGGTGC
CACCCCAATCAGTCTGCCGGAAGGGAAGTC|ATCAGGCACCTCGTTAATCTTTGATTAGAG
CCTGCTACCACCCCAATCAATTAGGGGAAA|CTCGGAGTGCTGCCCAGAACTTGCATATTC
CATTTCGTACTTTGGGACGCGAGTGGCCCA|ACCCGCTTCTGCGCCTACAATGAACTTTAC
CTACACAAGTTAACCCCCTGCTACCACCCC|ACCGCCAACAAGTTAACCCCCTGCTACCAC
CAGGCACCTCGTTAATCTTTGATTAGAGTG|ACCACCCCAATCAAACTGGAAACACCGCTT
ATCTGTGGCCCACGTGAACGATGATACATC|CACTCCACCAAGTTAACCCCCTGCTACCAC
AGGTGCGATGTTCGGCTCAAAAAAGCCACT|ACGACACTATTTGTGCCAGTACTTGGCATT
ATCACGGCACTTGACGCAAAACACCGCACC|TAATACTATGTAAACTTATCAGAACCGCCA
TGCAAGTTAACCCCCTGCTACCACCCCAAT|GCTACCACCCCAATCATTCGCATATCTGTA
GCCGTCCCAAGTTAACCCCCTGCTACCACC|CGGGTGACAAGTTAACCCCCTGCTACCACC
TACCCGCTTCTGCGCCTACAATGAACTTTA|TTAACCCCCTGCTACCACCCCAATCAGTCT
CCCCCTGCTACCACCCCAATCACGCTCGGG|CCCCCTGCTACCACCCAAGTTAACCCCCTG
CATGGGCTCGATGTACCCGCTTCTGCGCCT|AACGGCCGGCAAGTTAACCCCCTGCTACCA
ACGGAGGCGTAGGACAGATTGCCGTTAACG|CAATCACGGCAATGCCACCGTCTGATTTGC
GGGACGCGAGTGGCCCAAAACTAATCTGTG|CCTACAATGAACTTTACGAGATTCACTCCA
ACGAACGGCCGGCAAGTTAACCCCCTGCTA|TGCTACAAGTTAACCCCCTGCTACCACCCC
AATGAACTTTACGAGATTCACTCCACCAAG|CCAATCAGTCTGCCGGAAGGGAAGTCCCAT
CCAGAACTTGCATATTCCGGAAGCAAGTTA|GCTAATCTGCGAGTTGTCCGGGAGACAGAG
CGATGTTCGGCTCAAAAAAGCCACTCGTCC|ACTATTTGTGCCAGTACTTGGCATTTTGCA
CCCACGGAGGCGTAGGACAGATTGCCGTTA|CCCCAATCACGGCAATGCCACCGTCTGATT
TTGGGACGCGAGTGGCCCAAAACTAATCTG|CGCCTACAATGAACTTTACGAGATTCACTC
TATCGGACCTCGGAGTGCTGCCCAGAACTT|CTGAATGAGTCATTACGGGTCGCTAATCTG
ACCCCAATCAGTCTGCCGGAAGGGAAGTCC|TCAGGCACCTCGTTAATCTTTGATTAGAGT
GACGCGAGTGGCCCAAAACTAATCTGTGGC|TACAATGAACTTTACGAGATTCACTCCACC
TAACCCCCTGCTACCACCCCAATCACGCTC|TAACCCCCTGCTACCACCCAAGTTAACCCC
GAGATTCACTCCACCAAGTTAACCCCCTGC|CCGGAAGGGAAGTCCCATTACCGGGAGGGC
TCTGCTACACAAGTTAACCCCCTGCTACCA|CCGCACCGCCAACAAGTTAACCCCCTGCTA
CTGCTACCACCCCAATCAGGCACCTCGTTA|AAGTTAACCCCCTGCTACCACCCCAATCAA
TCCCAAGTTAACCCCCTGCTACCACCCCAA|TGACAAGTTAACCCCCTGCTACCACCCAAG
TGCTACAAGTTAACCCCCTGCTACCACCCC|TTCTATTTCTGCTACACAAGTTAACCCCCT
TCTCGAAATGGGCAGACAGCGACCGCATGG|GGCGTAGGACAGATTGCCGTTAACGAACGG
TGAACGTCTGCTCTGGTCTCTGTAATGTAC|CATTTCGTACTTTGGGACGCGAGTGGCCCA
TCACTGGGATGACAACACCAGGTGCGATGT|CTACCACCCCAATCATCGGACGACACTATT
TGATACATCGAGACCCTCTACCGGCAGTCA|TGCTACCACCCCAATCACCCGCTCTTCCCA
GAAACACCGCTTGAGAGCTGAGAGTCACTT|TAGGGGAAATCCAGTGACTCACAAGTTAAC